δὴ	δή	ADV	_	
γὰρ	γάρ	ADV	_	
θεοείκελός	θεοείκελος	ADJ	number=SINGULAR|gender=FEMININE|case=NOMINATIVE	
ἐσσι	εἰμί	VB	person=PERSON_2|number=SINGULAR|tense=PR|mood=INDICATIVE|voice=ACTIVE	
εἶπε	εἶπον	VB	person=PERSON_2|number=SINGULAR|mood=IMPERATIVE|voice=ACTIVE	
δὲ	δὲ	CONJ	_	
πῶς	πῶς	ADV	_	
σ̓	συ	PRON	number=SINGULAR|gender=FEMININE|case=ACCUSATIVE	
ἥρπαξεν	ἁρπάζω	VB	person=PERSON_3|number=SINGULAR|mood=INDICATIVE|voice=ACTIVE	
ὑπὸ	ὑπό	PREP	_	
ζόφον	ζόφος	NN	number=SINGULAR|gender=MASCULINE|case=ACCUSATIVE	
ἠερόεντα	ἠερόεις	ADJ	number=SINGULAR|gender=MASCULINE|case=ACCUSATIVE	
καὶ	καί	CONJ	_	
τίνι	τις	PRON	number=SINGULAR|case=DATIVE	
σ̓	συ	PRON	number=SINGULAR|gender=FEMININE|case=ACCUSATIVE	
ἐξαπάτησε	ἐξαπατάω	VB	person=PERSON_3|number=SINGULAR|mood=INDICATIVE|voice=ACTIVE	
δόλῳ	δόλος	NN	number=SINGULAR|gender=MASCULINE|case=DATIVE	
κρατερὸς	κρατερός	ADJ	number=SINGULAR|gender=MASCULINE|case=NOMINATIVE	
Πολυδέγμων	Πολυδέγμων	NN	number=SINGULAR|gender=MASCULINE|case=NOMINATIVE	
τοῦ	ὁ	PRON	number=SINGULAR|gender=MASCULINE|case=GENITIVE	
δὲ	δὲ	CONJ	_	
κασίγνηται	κασιγνήτη	NN	number=PLURAL|gender=FEMININE|case=NOMINATIVE	
φωνὴν	φωνή	NN	number=SINGULAR|gender=FEMININE|case=ACCUSATIVE	
ἐσάκουσαν	εἰσακούω	VB	person=PERSON_3|number=PLURAL|mood=INDICATIVE|voice=ACTIVE	
ἐλεινήν	ἐλεεινός	ADJ	number=SINGULAR|gender=FEMININE|case=ACCUSATIVE	
κὰδ	κάτα	ADV	_	
δ̓	δε	CONJ	_	
ἄῤ	ἄρα	ADV	_	
ἀπ̓	ἀπο	PREP	_	
εὐστρώτων	εὔστρωτος	ADJ	number=PLURAL|gender=NEUTER|case=GENITIVE	
λεχέων	λέχος	NN	number=PLURAL|gender=NEUTER|case=GENITIVE	
θόρον	θρῴσκω	VB	person=PERSON_3|number=PLURAL|mood=INDICATIVE|voice=ACTIVE	
καί	καί	CONJ	_	
νύ	νῦν	ADV	_	
κε	ἄν	ADV	_	
πάμπαν	πάμπαν	ADV	_	
ὄλεσσε	ὄλλυμι	VB	person=PERSON_3|number=SINGULAR|mood=INDICATIVE|voice=ACTIVE	
γένος	γένος	NN	number=SINGULAR|gender=NEUTER|case=ACCUSATIVE	
μερόπων	μέροψ	ADJ	number=PLURAL|gender=MASCULINE|case=GENITIVE	
ἀνθρώπων	ἄνθρωπος	NN	number=PLURAL|gender=MASCULINE|case=GENITIVE	
λιμοῦ	λιμός	NN	number=SINGULAR|gender=FEMININE|case=GENITIVE	
ὑπ̓	ὑπο	PREP	_	
ἀργαλέης	ἀργαλέος	ADJ	number=SINGULAR|gender=FEMININE|case=GENITIVE	
γεράων	γέρας	NN	number=PLURAL|gender=NEUTER|case=GENITIVE	
τ̓	τε	CONJ	_	
ἐρικυδέα	ἐρικυδής	ADJ	number=SINGULAR|gender=FEMININE|case=ACCUSATIVE	
τιμὴν	τιμή	NN	number=SINGULAR|gender=FEMININE|case=ACCUSATIVE	
καὶ	καί	CONJ	_	
θυσιῶν	θυσία	NN	number=PLURAL|gender=FEMININE|case=GENITIVE	
ἤμερσεν	ἀμέρδω	VB	person=PERSON_3|number=SINGULAR|mood=INDICATIVE|voice=ACTIVE	
Ὀλύμπια	Ὀλύμπιος	ADJ	number=PLURAL|gender=NEUTER|case=ACCUSATIVE	
δώματ̓	δῶμα	NN	number=PLURAL|gender=NEUTER|case=ACCUSATIVE	
ἔχοντας	ἔχω	VB	number=PLURAL|tense=PR|mood=PARTICIPLE|voice=ACTIVE|gender=MASCULINE|case=ACCUSATIVE	
εἰ	εἰ	CONJ	_	
μὴ	μὴ	ADV	_	
Ζεὺς	Ζεύς	NN	number=SINGULAR|gender=MASCULINE|case=NOMINATIVE	
ἐνόησεν	νοέω	VB	person=PERSON_3|number=SINGULAR|mood=INDICATIVE|voice=ACTIVE	
ἑῷ	ἑός	ADJ	number=SINGULAR|gender=MASCULINE|case=DATIVE	
τ̓	τε	CONJ	_	
ἐφράσσατο	φράζω	VB	person=PERSON_3|number=SINGULAR|mood=INDICATIVE	
θυμῷ	θυμός	NN	number=SINGULAR|gender=MASCULINE|case=DATIVE	
Ἠέλιον	Ἥλιος	NN	number=SINGULAR|gender=MASCULINE|case=ACCUSATIVE	
δ̓	δε	CONJ	_	
ἵκοντο	ἱκνέομαι	VB	person=PERSON_3|number=PLURAL|mood=INDICATIVE	
θεῶν	θεὸς	NN	number=PLURAL|gender=MASCULINE|case=GENITIVE	
σκοπὸν	σκοπός	NN	number=SINGULAR|gender=MASCULINE|case=ACCUSATIVE	
ἠδὲ	ἠδέ	CONJ	_	
καὶ	καί	CONJ	_	
ἀνδρῶν	ἀνήρ	NN	number=PLURAL|gender=MASCULINE|case=GENITIVE	
στὰν	ἵστημι	VB	person=PERSON_3|number=PLURAL|mood=INDICATIVE|voice=ACTIVE	
δ̓	δε	CONJ	_	
ἵππων	ἵππος	NN	number=PLURAL|gender=MASCULINE|case=GENITIVE	
προπάροιθε	προπάροιθε	PREP	_	
καὶ	καί	CONJ	_	
εἴρετο	εἴρω	VB	person=PERSON_3|number=SINGULAR|tense=IMP|mood=INDICATIVE	
δῖα	δῖος	ADJ	number=SINGULAR|gender=FEMININE|case=NOMINATIVE	
θεάων	θέα	NN	number=PLURAL|gender=FEMININE|case=GENITIVE	
νῦν	νῦν	ADV	_	
δ̓	δε	CONJ	_	
οὐκ	οὐ	ADV	_	
ἔσθ̓	εἰμι	VB	person=PERSON_3|number=SINGULAR|tense=FUTURE|mood=INDICATIVE|voice=ACTIVE	
ὥς	ὡς	CONJ	_	
κεν	ἄν	ADV	_	
θάνατον	θάνατος	NN	number=SINGULAR|gender=MASCULINE|case=ACCUSATIVE	
καὶ	καί	CONJ	_	
κῆρας	κήρ	NN	number=PLURAL|gender=FEMININE|case=ACCUSATIVE	
ἀλύξαι	ἀλύζω	VB	person=PERSON_3|number=SINGULAR|voice=ACTIVE	
ὣς	ὡς	CONJ	_	
ἔφαν	φημί	VB	person=PERSON_3|number=PLURAL|tense=IMP|mood=INDICATIVE|voice=ACTIVE	
μέγα	μέγας	ADJ	number=SINGULAR|gender=NEUTER|case=NOMINATIVE	
γάρ	γάρ	ADV	_	
τι	τι	ADV	_	
θεῶν	θεὸς	NN	number=PLURAL|gender=MASCULINE|case=GENITIVE	
σέβας	σέβας	NN	number=SINGULAR|gender=NEUTER|case=NOMINATIVE	
ἰσχάνει	ἰσχάνω	VB	person=PERSON_3|number=SINGULAR|tense=PR|mood=INDICATIVE|voice=ACTIVE	
αὐδήν	αὐδή	NN	number=SINGULAR|gender=FEMININE|case=ACCUSATIVE	
στῆσε	ἵστημι	VB	person=PERSON_3|number=SINGULAR|mood=INDICATIVE|voice=ACTIVE	
δ̓	δε	CONJ	_	
ἄγων	ἄγω	VB	number=SINGULAR|tense=PR|mood=PARTICIPLE|voice=ACTIVE|gender=MASCULINE|case=NOMINATIVE	
ὅθι	ὅθι	ADV	_	
μίμνεν	μίμνω	VB	person=PERSON_3|number=SINGULAR|tense=IMP|mood=INDICATIVE|voice=ACTIVE	
ἐυστέφανος	εὐστέφανος	ADJ	number=SINGULAR|gender=FEMININE|case=NOMINATIVE	
Δημήτηρ	Δημήτηρ	NN	number=SINGULAR|gender=FEMININE|case=NOMINATIVE	
νηοῖο	ναός	NN	number=SINGULAR|gender=MASCULINE|case=GENITIVE	
προπάροιθε	προπάροιθε	PREP	_	
θυώδεος	θυώδης	ADJ	number=SINGULAR|gender=MASCULINE|case=GENITIVE	
Δήμητῤ	Δήμητηρ	NN	number=SINGULAR|gender=FEMININE|case=ACCUSATIVE	
ἠύκομον	εὔκομος	ADJ	number=SINGULAR|gender=FEMININE|case=ACCUSATIVE	
σεμνὴν	σεμνός	ADJ	number=SINGULAR|gender=FEMININE|case=ACCUSATIVE	
θεόν	θεός	NN	number=SINGULAR|gender=FEMININE|case=ACCUSATIVE	
ἄρχομ̓	ἄρχω	VB	person=PERSON_1|number=SINGULAR|tense=PR|mood=INDICATIVE	
ἀείδειν	ἀείδω	VB	tense=PR|mood=INFINITIVE|voice=ACTIVE	
αὐτὴν	αὐτός	PRON	number=SINGULAR|gender=FEMININE|case=ACCUSATIVE	
ἠδὲ	ἠδέ	CONJ	_	
θύγατρα	θυγάτηρ	NN	number=SINGULAR|gender=FEMININE|case=ACCUSATIVE	
τανύσφυρον	τανύσφυρος	ADJ	number=SINGULAR|gender=FEMININE|case=ACCUSATIVE	
ἣν	ὅς	PRON	number=SINGULAR|gender=FEMININE|case=ACCUSATIVE	
Ἀιδωνεὺς	Ἅιδης	NN	number=SINGULAR|gender=MASCULINE|case=NOMINATIVE	
ἥρπαξεν	ἁρπάζω	VB	person=PERSON_3|number=SINGULAR|mood=INDICATIVE|voice=ACTIVE	
δῶκεν	δίδωμι	VB	person=PERSON_3|number=SINGULAR|mood=INDICATIVE|voice=ACTIVE	
δὲ	δὲ	CONJ	_	
βαρύκτυπος	βαρύκτυπος	ADJ	number=SINGULAR|gender=MASCULINE|case=NOMINATIVE	
εὐρύοπα	εὐρύοπα	ADJ	number=SINGULAR|gender=MASCULINE|case=NOMINATIVE	
Ζεύς	Ζεύς	NN	number=SINGULAR|gender=MASCULINE|case=NOMINATIVE	
νόσφιν	νόσφι	PREP	_	
Δήμητρος	Δημήτηρ	NN	number=SINGULAR|gender=FEMININE|case=GENITIVE	
χρυσαόρου	χρυσάορος	ADJ	number=SINGULAR|gender=FEMININE|case=GENITIVE	
ἀγλαοκάρπου	ἀγλαόκαρπος	ADJ	number=SINGULAR|gender=FEMININE|case=GENITIVE	
παίζουσαν	παίζω	VB	number=SINGULAR|tense=PR|mood=PARTICIPLE|voice=ACTIVE|gender=FEMININE|case=ACCUSATIVE	
κούρῃσι	κόρη	NN	number=PLURAL|gender=FEMININE|case=DATIVE	
σὺν	σύν	PREP	_	
Ὠκεανοῦ	Ὠκεανός	NN	number=SINGULAR|gender=MASCULINE|case=GENITIVE	
βαθυκόλποις	βαθύκολπος	ADJ	number=PLURAL|gender=FEMININE|case=DATIVE	
ἄνθεά	ἄνθος	NN	number=PLURAL|gender=NEUTER|case=ACCUSATIVE	
τ̓	τε	CONJ	_	
αἰνυμένην	αἴνυμαι	VB	number=SINGULAR|tense=PR|mood=PARTICIPLE|gender=FEMININE|case=ACCUSATIVE	
ῥόδα	ῥόδον	NN	number=PLURAL|gender=NEUTER|case=ACCUSATIVE	
καὶ	καί	CONJ	_	
κρόκον	κρόκος	NN	number=SINGULAR|gender=MASCULINE|case=ACCUSATIVE	
ἠδ̓	ἠδη	CONJ	_	
ἴα	ἴα	NN	number=PLURAL|gender=NEUTER|case=ACCUSATIVE	
καλὰ	καλός	ADJ	number=PLURAL|gender=NEUTER|case=ACCUSATIVE	
λειμῶν̓	λειμῶν	NN	number=SINGULAR|gender=MASCULINE|case=ACCUSATIVE	
ἂμ	ἀνά	PREP	_	
μαλακὸν	μαλακός	ADJ	number=SINGULAR|gender=MASCULINE|case=ACCUSATIVE	
καὶ	καί	CONJ	_	
ἀγαλλίδας	ἀγαλλίς	NN	number=PLURAL|gender=FEMININE|case=ACCUSATIVE	
ἠδ̓	ἠδη	CONJ	_	
ὑάκινθον	ὑάκινθος	NN	number=SINGULAR|gender=MASCULINE|case=ACCUSATIVE	
νάρκισσόν	νάρκισσος	NN	number=SINGULAR|gender=FEMININE|case=ACCUSATIVE	
θ̓	τε	CONJ	_	
ὃν	ὅς	PRON	number=SINGULAR|gender=MASCULINE|case=ACCUSATIVE	
φῦσε	φύω	VB	person=PERSON_3|number=SINGULAR|mood=INDICATIVE|voice=ACTIVE	
δόλον	δόλος	NN	number=SINGULAR|gender=MASCULINE|case=ACCUSATIVE	
καλυκώπιδι	καλυκώπις	ADJ	number=SINGULAR|gender=FEMININE|case=DATIVE	
κούρῃ	κόρη	NN	number=SINGULAR|gender=FEMININE|case=DATIVE	
Γαῖα	Γαῖα	NN	number=SINGULAR|gender=FEMININE|case=NOMINATIVE	
Διὸς	Ζεύς	NN	number=SINGULAR|gender=MASCULINE|case=GENITIVE	
βουλῇσι	βουλή	NN	number=PLURAL|gender=FEMININE|case=DATIVE	
χαριζομένη	χαρίζω	VB	number=SINGULAR|tense=PR|mood=PARTICIPLE|gender=FEMININE|case=NOMINATIVE	
Πολυδέκτῃ	Πολυδέκτης	NN	number=SINGULAR|gender=MASCULINE|case=DATIVE	
θαυμαστὸν	θαυμαστός	ADJ	number=SINGULAR|gender=NEUTER|case=ACCUSATIVE	
γανόωντα	γανόω	VB	number=SINGULAR|tense=PR|mood=PARTICIPLE|voice=ACTIVE|gender=MASCULINE|case=ACCUSATIVE	
τὴν	ὁ	PRON	number=SINGULAR|gender=FEMININE|case=ACCUSATIVE	
δ̓	δε	CONJ	_	
ἀεκαζομένην	ἀεκαζόμενος	ADJ	number=SINGULAR|gender=FEMININE|case=ACCUSATIVE	
ἦγεν	ἄγω	VB	person=PERSON_3|number=SINGULAR|tense=IMP|mood=INDICATIVE|voice=ACTIVE	
Διὸς	Ζεύς	NN	number=SINGULAR|gender=MASCULINE|case=GENITIVE	
ἐννεσίῃσι	ἐννεσία	NN	number=PLURAL|gender=FEMININE|case=DATIVE	
πατροκασίγνητος	πατροκασίγνητος	NN	number=SINGULAR|gender=MASCULINE|case=NOMINATIVE	
Πολυσημάντωρ	Πολυσημάντωρ	ADJ	number=SINGULAR|gender=MASCULINE|case=NOMINATIVE	
Πολυδέγμων	Πολυδέγμων	NN	number=SINGULAR|gender=MASCULINE|case=NOMINATIVE	
ἵπποις	ἵππος	NN	number=PLURAL|gender=MASCULINE|case=DATIVE	
ἀθανάτοισι	ἀθάνατος	ADJ	number=PLURAL|gender=MASCULINE|case=DATIVE	
Κρόνου	Κρόνος	NN	number=SINGULAR|gender=MASCULINE|case=GENITIVE	
πολυώνυμος	πολυώνυμος	ADJ	number=SINGULAR|gender=MASCULINE|case=NOMINATIVE	
υἱός	υἱός	NN	number=SINGULAR|gender=MASCULINE|case=NOMINATIVE	
οὐ	οὐ	ADV	_	
δ̓	δε	CONJ	_	
ἀπίθησεν	ἀπιθέω	VB	person=PERSON_3|number=SINGULAR|mood=INDICATIVE|voice=ACTIVE	
ἐυστέφανος	εὐστέφανος	ADJ	number=SINGULAR|gender=FEMININE|case=NOMINATIVE	
Δημήτηρ	Δημήτηρ	NN	number=SINGULAR|gender=FEMININE|case=NOMINATIVE	
τῶν	ὁ		number=PLURAL|gender=MASCULINE|case=GENITIVE	
δ̓	δε	CONJ	_	
ἀδικησάντων	ἀδικέω	VB	number=PLURAL|mood=PARTICIPLE|voice=ACTIVE|gender=MASCULINE|case=GENITIVE	
τίσις	τίσις	NN	number=SINGULAR|gender=FEMININE|case=NOMINATIVE	
ἔσσεται	εἰμί	VB	person=PERSON_3|number=SINGULAR|tense=FUTURE|mood=INDICATIVE	
ἤματα	ἦμαρ	NN	number=PLURAL|gender=NEUTER|case=ACCUSATIVE	
πάντα	πᾶς	ADJ	number=PLURAL|gender=NEUTER|case=ACCUSATIVE	
οἵ	ὅς	PRON	number=PLURAL|gender=MASCULINE|case=NOMINATIVE	
κεν	ἄν	ADV	_	
μὴ	μὴ	ADV	_	
θυσίῃσι	θυσία	NN	number=PLURAL|gender=FEMININE|case=DATIVE	
τεὸν	τεός	ADJ	number=SINGULAR|gender=NEUTER|case=ACCUSATIVE	
μένος	μένος	NN	number=SINGULAR|gender=NEUTER|case=ACCUSATIVE	
ἱλάσκωνται	ἱλάσκομαι	VB	person=PERSON_3|number=PLURAL|tense=PR|mood=SUBJUNCTIVE	
εὐαγέως	εὐαγης	ADV	_	
ἔρδοντες	ἔρδω	VB	number=PLURAL|tense=PR|mood=PARTICIPLE|voice=ACTIVE|gender=MASCULINE|case=NOMINATIVE	
ἐναίσιμα	ἐναίσιμος	ADJ	number=PLURAL|gender=NEUTER|case=ACCUSATIVE	
δῶρα	δῶρον	NN	number=PLURAL|gender=NEUTER|case=ACCUSATIVE	
τελοῦντες	τέλλω	VB	number=PLURAL|tense=FUTURE|mood=PARTICIPLE|voice=ACTIVE|gender=MASCULINE|case=NOMINATIVE	
ἐξαύδα	ἐξαυδάω	VB	person=PERSON_2|number=SINGULAR|tense=PR|mood=IMPERATIVE|voice=ACTIVE	
μ[ὴ	μ[ὴ	ADV	_	
κεῦθ̓	κεῦθω	VB	person=PERSON_2|number=SINGULAR|tense=PR|mood=IMPERATIVE|voice=ACTIVE	
ἵνα	ἵνα	CONJ	_	
εἴδομεν	οἶδα	VB	person=PERSON_1|number=PLURAL|tense=PERF|mood=SUBJUNCTIVE|voice=ACTIVE	
ἄμφω	ἄμφω	ADJ	gender=NEUTER|case=ACCUSATIVE	
τέτμον	τέτμον	VB	person=PERSON_3|number=PLURAL|mood=INDICATIVE|voice=ACTIVE	
δ̓	δε	CONJ	_	
ἐγγὺς	ἐγγὺς	PREP	_	
ὁδοῦ	ὁδός	NN	number=SINGULAR|gender=MASCULINE|case=GENITIVE	
κυδρὴν	κυδρός	ADJ	number=SINGULAR|gender=FEMININE|case=ACCUSATIVE	
θεόν	θεός	NN	number=SINGULAR|gender=FEMININE|case=ACCUSATIVE	
ἔνθα	ἔνθα	CONJ	_	
πάρος	πάρος	ADV	_	
περ	πέρ	ADV	_	
κάλλιπον	καταλιμπάνω	VB	person=PERSON_3|number=PLURAL|mood=INDICATIVE|voice=ACTIVE	
ἣ	ὁ	PRON	number=SINGULAR|gender=FEMININE|case=NOMINATIVE	
δ̓	δε	CONJ	_	
ἄῤ	ἄρα	ADV	_	
ἐπ̓	ἐπι	PREP	_	
οὐδὸν	οὐδός	NN	number=SINGULAR|gender=MASCULINE|case=ACCUSATIVE	
ἔβη	βαίνω	VB	person=PERSON_3|number=SINGULAR|mood=INDICATIVE|voice=ACTIVE	
ποσὶ	πούς	NN	number=PLURAL|gender=MASCULINE|case=DATIVE	
καὶ	καί	CONJ	_	
ῥα	ἄρα	ADV	_	
μελάθρου	μέλαθρον	NN	number=SINGULAR|gender=NEUTER|case=GENITIVE	
κῦρε	κυρέω	VB	person=PERSON_3|number=SINGULAR|tense=IMP|mood=INDICATIVE|voice=ACTIVE	
κάρη	κάρα	NN	number=SINGULAR|gender=NEUTER|case=ACCUSATIVE	
πλῆσεν	πίμπλημι	VB	person=PERSON_3|number=SINGULAR|mood=INDICATIVE|voice=ACTIVE	
δὲ	δὲ	CONJ	_	
θύρας	θύρα	NN	number=PLURAL|gender=FEMININE|case=ACCUSATIVE	
σέλαος	σέλας	NN	number=SINGULAR|gender=NEUTER|case=GENITIVE	
θείοιο	θεῖος	ADJ	number=SINGULAR|gender=NEUTER|case=GENITIVE	
[νεῦσε	νεύω	VB	person=PERSON_3|number=SINGULAR|mood=INDICATIVE|voice=ACTIVE	
δέ	δέ	CONJ	_	
σοι	σύ	PRON	person=PERSON_2|number=SINGULAR|case=DATIVE	
κούρην	κόρη	NN	number=SINGULAR|gender=FEMININE|case=ACCUSATIVE	
ἔτεος	ἔτος	NN	number=SINGULAR|gender=NEUTER|case=GENITIVE	
π]εριτελλομένοιο	περιτέλλομαι	VB	number=SINGULAR|mood=PARTICIPLE|gender=NEUTER|case=GENITIVE	
[τὴν	ὁ		number=SINGULAR|gender=FEMININE|case=ACCUSATIVE	
τριτάτην	τρίτατος	ADJ	number=SINGULAR|gender=FEMININE|case=ACCUSATIVE	
μὲν	μέν	ADV	_	
μοῖραν	μοῖρα	NN	number=SINGULAR|gender=FEMININE|case=ACCUSATIVE	
ὑπὸ	ὑπό	PREP	_	
ζόφον	ζόφος	NN	number=SINGULAR|gender=MASCULINE|case=ACCUSATIVE	
ἠ]ερόεντα	ἠερόεις	ADJ	number=SINGULAR|gender=MASCULINE|case=ACCUSATIVE	
[τὰς	ὁ		number=PLURAL|gender=FEMININE|case=ACCUSATIVE	
δὲ	δὲ	CONJ	_	
δύω	δύο	NRL	_	
παρὰ	παρά	PREP	_	
σοί	σύ	PRON	person=PERSON_2|number=SINGULAR|case=DATIVE	
καὶ	καί	CONJ	_	
ἄλλοις]	ἄλλος	PRON	number=PLURAL|gender=MASCULINE|case=DATIVE	
ἀθανάτοισιν	ἀθάνατος	ADJ	number=PLURAL|gender=MASCULINE|case=DATIVE	
εἰναι	εἰναι	VB	tense=PR|mood=INFINITIVE|voice=ACTIVE	
εἰναι	εἰναι	VB	tense=PR|mood=INFINITIVE|voice=ACTIVE	
ἐμὲ	ἐγώ	PRON	person=PERSON_1|number=SINGULAR|gender=FEMININE|case=ACCUSATIVE	
δ̓	δε	CONJ	_	
αὖτ̓	αὖτε	ADV	_	
οἰκτείρατε	οἰκτείρω	VB	person=PERSON_2|number=PLURAL|mood=IMPERATIVE|voice=ACTIVE	
κοῦραι	κόρη	NN	number=PLURAL|gender=FEMININE|case=VOCATIVE	
γαῖα	γαῖα	NN	number=SINGULAR|gender=FEMININE|case=NOMINATIVE	
δ̓	δε	CONJ	_	
ἔνερθε	ἔνερθε	ADV	_	
χώρησεν	χωρέω	VB	person=PERSON_3|number=SINGULAR|mood=INDICATIVE|voice=ACTIVE	
ὣς	ὣς	CONJ	_	
φάτο	φημί	VB	person=PERSON_3|number=SINGULAR|tense=IMP|mood=INDICATIVE	
ἣ	ὁ	PRON	number=SINGULAR|gender=FEMININE|case=NOMINATIVE	
δ̓	δε	CONJ	_	
ὀχέων	ὄχος	NN	number=PLURAL|gender=NEUTER|case=GENITIVE	
ἐπέβη	ἐπιβαίνω	VB	person=PERSON_3|number=SINGULAR|mood=INDICATIVE|voice=ACTIVE	
πάρα	παρά	PREP	_	
δὲ	δὲ	CONJ	_	
κρατὺς	κρατύς	ADJ	number=SINGULAR|gender=MASCULINE|case=NOMINATIVE	
Ἀργειφόντης	Ἀργειφόντης	NN	number=SINGULAR|gender=MASCULINE|case=NOMINATIVE	
ἡνία	ἡνίον	NN	number=PLURAL|gender=NEUTER|case=ACCUSATIVE	
καὶ	καί	CONJ	_	
μάστιγα	μάστιξ	NN	number=SINGULAR|gender=FEMININE|case=ACCUSATIVE	
λαβὼν	λαμβάνω	VB	number=SINGULAR|mood=PARTICIPLE|voice=ACTIVE|gender=MASCULINE|case=NOMINATIVE	
μετὰ	μετά	PREP	_	
χερσὶ	χείρ	NN	number=PLURAL|gender=FEMININE|case=DATIVE	
φίλῃσι	φίλος	ADJ	number=PLURAL|gender=FEMININE|case=DATIVE	
σεῦε	σεύω	VB	person=PERSON_3|number=SINGULAR|mood=INDICATIVE|voice=ACTIVE	
διὲκ	διέκ	PREP	_	
μεγάρων	μέγαρον	NN	number=PLURAL|gender=NEUTER|case=GENITIVE	
ἑ	ἕ	PRON	number=SINGULAR|gender=FEMININE|case=ACCUSATIVE	
εἶξε	εἴκω	VB	person=PERSON_3|number=SINGULAR|mood=INDICATIVE|voice=ACTIVE	
δέ	δέ	CONJ	_	
οἱ	ἕ	PRON	number=SINGULAR|gender=FEMININE|case=DATIVE	
κλισμοῖο	κλισμός	NN	number=SINGULAR|gender=MASCULINE|case=GENITIVE	
καὶ	καί	CONJ	_	
ἑδριάασθαι	ἑδριάω	VB	tense=PR|mood=INFINITIVE	
ἄνωγεν	ἄνωγα	VB	person=PERSON_3|number=SINGULAR|tense=PERF|mood=INDICATIVE|voice=ACTIVE	
κώκυσεν	κωκύω	VB	person=PERSON_3|number=SINGULAR|mood=INDICATIVE|voice=ACTIVE	
δὲ	δὲ	CONJ	_	
καὶ	καί	CONJ	_	
ἄμφω	ἄμφω	ADJ	gender=MASCULINE|case=ACCUSATIVE	
πλήξατο	πλήσσω	VB	person=PERSON_3|number=SINGULAR|mood=INDICATIVE	
μηρὼ	μηρός	NN	gender=MASCULINE|case=ACCUSATIVE	
δείσασ̓	δείδω	VB	number=SINGULAR|mood=PARTICIPLE|voice=ACTIVE|gender=FEMININE|case=NOMINATIVE	
ᾧ	ὅς	PRON	number=SINGULAR|gender=MASCULINE|case=DATIVE	
περὶ	περί	PREP	_	
παιδὶ	παῖς	NN	number=SINGULAR|gender=MASCULINE|case=DATIVE	
καὶ	καί	CONJ	_	
ἀάσθη	ἀάω	VB	person=PERSON_3|number=SINGULAR|mood=INDICATIVE|voice=PASSIVE	
μέγα	μέγα	ADV	_	
θυμῷ	θυμός	NN	number=SINGULAR|gender=MASCULINE|case=DATIVE	
καί	καί	CONJ	_	
ῥ̓	ἄρα	ADV	_	
ὀλοφυρομένη	ὀλοφύρομαι	VB	number=SINGULAR|tense=PR|mood=PARTICIPLE|gender=FEMININE|case=NOMINATIVE	
ἔπεα	ἔπος	NN	number=PLURAL|gender=NEUTER|case=ACCUSATIVE	
πτερόεντα	πτερόεις	ADJ	number=PLURAL|gender=NEUTER|case=ACCUSATIVE	
προσηύδα	προσαυδάω	VB	person=PERSON_3|number=SINGULAR|tense=IMP|mood=INDICATIVE|voice=ACTIVE	
τὴν	ὁ	PRON	number=SINGULAR|gender=FEMININE|case=ACCUSATIVE	
δ̓	δε	CONJ	_	
αἰδώς	αἰδώς	NN	number=SINGULAR|gender=FEMININE|case=NOMINATIVE	
τε	τε	CONJ	_	
σέβας	σέβας	NN	number=SINGULAR|gender=NEUTER|case=NOMINATIVE	
τε	τε	CONJ	_	
ἰδὲ	ἰδέ	CONJ	_	
χλωρὸν	χλωρός	ADJ	number=SINGULAR|gender=NEUTER|case=NOMINATIVE	
δέος	δέος	NN	number=SINGULAR|gender=NEUTER|case=NOMINATIVE	
εἷλεν	αἱρέω	VB	person=PERSON_3|number=SINGULAR|mood=INDICATIVE|voice=ACTIVE	
σέβας	σέβας	NN	number=SINGULAR|gender=NEUTER|case=NOMINATIVE	
τό	ὁ	PRON	number=SINGULAR|gender=NEUTER|case=NOMINATIVE	
γε	γε	ADV	_	
πᾶσιν	πᾶς	ADJ	number=PLURAL|gender=MASCULINE|case=DATIVE	
ἰδέσθαι	εἶδον	VB	mood=INFINITIVE	
ἀθανάτοις	ἀθάνατος	ADJ	number=PLURAL|gender=MASCULINE|case=DATIVE	
τε	τε	CONJ	_	
θεοῖς	θεός	NN	number=PLURAL|gender=MASCULINE|case=DATIVE	
ἠδὲ	ἠδέ	CONJ	_	
θνητοῖς	θνητός	ADJ	number=PLURAL|gender=MASCULINE|case=DATIVE	
ἀνθρώποις	ἄνθρωπος	NN	number=PLURAL|gender=MASCULINE|case=DATIVE	
ἐστι	εἰμί	VB	person=PERSON_3|number=SINGULAR|tense=PR|mood=INDICATIVE|voice=ACTIVE	
ἤχησαν	ἠχέω	VB	person=PERSON_3|number=PLURAL|mood=INDICATIVE|voice=ACTIVE	
δ̓	δε	CONJ	_	
ὀρέων	ὀρεύς	NN	number=PLURAL|gender=MASCULINE|case=GENITIVE	
κορυφαὶ	κορυφή	NN	number=PLURAL|gender=FEMININE|case=NOMINATIVE	
καὶ	καί	CONJ	_	
βένθεα	βένθος	NN	number=PLURAL|gender=NEUTER|case=NOMINATIVE	
πόντου	πόντος	NN	number=SINGULAR|gender=MASCULINE|case=GENITIVE	
φωνῇ	φωνή	NN	number=SINGULAR|gender=FEMININE|case=DATIVE	
ὑπ̓	ὑπο	PREP	_	
ἀθανάτῃ	ἀθάνατος	ADJ	number=SINGULAR|gender=FEMININE|case=DATIVE	
ἰάχησε	ἰαχέω	VB	person=PERSON_3|number=SINGULAR|mood=INDICATIVE|voice=ACTIVE	
δ̓	δε	CONJ	_	
ἄῤ	ἄρα	ADV	_	
ὄρθια	ὄρθια	ADV	_	
φωνῇ	φωνή	NN	number=SINGULAR|gender=FEMININE|case=DATIVE	
κεκλομένη	κέλομαι	VB	number=SINGULAR|mood=PARTICIPLE|gender=FEMININE|case=NOMINATIVE	
πατέρα	πατήρ	NN	number=SINGULAR|gender=MASCULINE|case=ACCUSATIVE	
Κρονίδην	Κρονίδης	NN	number=SINGULAR|gender=MASCULINE|case=ACCUSATIVE	
ὕπατον	ὕπατος	ADJ	number=SINGULAR|gender=MASCULINE|case=ACCUSATIVE	
καὶ	καί	CONJ	_	
ἄριστον	ἄριστος	ADJ	number=SINGULAR|gender=MASCULINE|case=ACCUSATIVE	
ἣ	ὁ	PRON	number=SINGULAR|gender=FEMININE|case=NOMINATIVE	
δὲ	δὲ	CONJ	_	
μάλ̓	μάλα	ADV	_	
ὦκα	ὦκα	ADV	_	
ἐλθούσας	ἔρχομαι	VB	number=SINGULAR|mood=PARTICIPLE|voice=ACTIVE|gender=FEMININE|case=GENITIVE	
ἐκέλευε	κελεύω	VB	person=PERSON_3|number=SINGULAR|tense=IMP|mood=INDICATIVE|voice=ACTIVE	
καλεῖν	καλέω	VB	tense=PR|mood=INFINITIVE|voice=ACTIVE	
ἐπ̓	ἐπι	PREP	_	
ἀπείρονι	ἀπείρων	ADJ	number=SINGULAR|case=DATIVE	
μισθῷ	μισθός	NN	number=SINGULAR|gender=MASCULINE|case=DATIVE	
ἣ	ὁ	PRON	number=SINGULAR|gender=FEMININE|case=NOMINATIVE	
δ̓	δε	CONJ	_	
ἄρα	ἄρα	ADV	_	
πῦρ	πῦρ	NN	number=SINGULAR|gender=NEUTER|case=ACCUSATIVE	
ἀνέκαἰ	ἀνακαίω	VB	person=PERSON_3|number=SINGULAR|tense=IMP|mood=INDICATIVE|voice=ACTIVE	
Τὴν	ὁ	PRON	number=SINGULAR|gender=FEMININE|case=ACCUSATIVE	
δ̓	δε	CONJ	_	
ἄχος	ἄχος	NN	number=SINGULAR|gender=NEUTER|case=NOMINATIVE	
αἰνότερον	αἰνός	ADJ	number=SINGULAR|gender=NEUTER|case=NOMINATIVE|degree=COMPARATIVE	
καὶ	καί	CONJ	_	
κύντερον	κύντερος	ADJ	number=SINGULAR|gender=NEUTER|case=NOMINATIVE	
ἵκετο	ἱκνέομαι	VB	person=PERSON_3|number=SINGULAR|mood=INDICATIVE	
θυμόν	θυμός	NN	number=SINGULAR|gender=MASCULINE|case=ACCUSATIVE	
τῇσιν	ὁ	PRON	number=PLURAL|gender=FEMININE|case=DATIVE	
δ̓	δε	CONJ	_	
ἐγγύθεν	ἐγγύθεν	ADV	_	
ἦλθ̓	ερχομαι	VB	person=PERSON_3|number=SINGULAR|mood=INDICATIVE|voice=ACTIVE	
Ἑκάτη	Ἑκάτη	NN	number=SINGULAR|gender=FEMININE|case=NOMINATIVE	
λιπαροκρήδεμνος	λιπαροκρήδεμνος	ADJ	number=SINGULAR|gender=FEMININE|case=NOMINATIVE	
ἐγὼ	ἐγώ	PRON	person=PERSON_1|number=SINGULAR|gender=FEMININE|case=NOMINATIVE	
δ̓	δε	CONJ	_	
ὑμῖν	σύ	PRON	person=PERSON_2|number=PLURAL|case=DATIVE	
μυθήσομαι	μυθέομαι	VB	person=PERSON_1|number=SINGULAR|tense=FUTURE|mood=INDICATIVE	
οὐδέ	οὐδέ	CONJ	_	
τι	τι	ADV	_	
γαῖα	γαῖα	NN	number=SINGULAR|gender=FEMININE|case=NOMINATIVE	
σπέρμ̓	σπέρμα	NN	number=PLURAL|gender=NEUTER|case=ACCUSATIVE	
ἀνίει	ἀνίημι	VB	person=PERSON_3|number=SINGULAR|tense=IMP|mood=INDICATIVE|voice=ACTIVE	
κρύπτεν	κρύπτω	VB	person=PERSON_3|number=SINGULAR|tense=IMP|mood=INDICATIVE|voice=ACTIVE	
γὰρ	γάρ	ADV	_	
ἐυστέφανος	εὐστέφανος	ADJ	number=SINGULAR|gender=FEMININE|case=NOMINATIVE	
Δημήτηρ	Δημήτηρ	NN	number=SINGULAR|gender=FEMININE|case=NOMINATIVE	
λάθρη	λάθρῃ	ADV	_	
δ̓	δε	CONJ	_	
ὁρμηθεῖσα	ὁρμέω	VB	number=SINGULAR|mood=PARTICIPLE|voice=PASSIVE|gender=FEMININE|case=NOMINATIVE	
δἰ	διὰ	PREP	_	
ἠπείροιο	ἤπειρος	NN	number=SINGULAR|gender=FEMININE|case=GENITIVE	
μελαίνης	μέλας	ADJ	number=SINGULAR|gender=FEMININE|case=GENITIVE	
φεύγου	φεύγω	VB	person=PERSON_2|number=SINGULAR|tense=PR|mood=IMPERATIVE	
ὑπερφιάλους	ὑπερφίαλος	ADJ	number=PLURAL|gender=MASCULINE|case=ACCUSATIVE	
σημάντορας	σημάντωρ	NN	number=PLURAL|gender=MASCULINE|case=ACCUSATIVE	
ὄφρα	ὄφρα	CONJ	_	
κε	ἄν	ADV	_	
μή	μή	ADV	_	
με	ἐγώ	PRON	person=PERSON_1|number=SINGULAR|gender=FEMININE|case=ACCUSATIVE	
ἀπριάτην	ἀπρίατος	ADJ	number=SINGULAR|gender=FEMININE|case=ACCUSATIVE	
περάσαντες	περάω	VB	number=PLURAL|mood=PARTICIPLE|voice=ACTIVE|gender=MASCULINE|case=NOMINATIVE	
ἐμῆς	ἐμός	ADJ	number=SINGULAR|gender=FEMININE|case=GENITIVE	
ἀποναίατο	ἀπονίναμαι	VB	person=PERSON_3|number=PLURAL	
τιμῆς	τιμή	NN	number=SINGULAR|gender=FEMININE|case=GENITIVE	
καὶ	καί	CONJ	_	
κεν	ἄν	ADV	_	
παῖδα	παῖς	NN	number=SINGULAR|gender=MASCULINE|case=ACCUSATIVE	
νεογνὸν	νεογνός	ADJ	number=SINGULAR|gender=MASCULINE|case=ACCUSATIVE	
ἐν	ἐν	PREP	_	
ἀγκοίνῃσιν	ἀγκοίνη	NN	number=PLURAL|gender=FEMININE|case=DATIVE	
ἔχουσα	ἔχω	VB	number=SINGULAR|tense=PR|mood=PARTICIPLE|voice=ACTIVE|gender=FEMININE|case=NOMINATIVE	
καλὰ	καλός	ADJ	number=PLURAL|gender=NEUTER|case=ACCUSATIVE	
τιθηνοίμην	τιθηνέω	VB	person=PERSON_1|number=SINGULAR|tense=PR	
καὶ	καί	CONJ	_	
δώματα	δῶμα	NN	number=PLURAL|gender=NEUTER|case=ACCUSATIVE	
τηρήσαιμι	τηρέω	VB	person=PERSON_1|number=SINGULAR|voice=ACTIVE	
καί	καί	CONJ	_	
κε	ἄν	ADV	_	
λέχος	λέχος	NN	number=SINGULAR|gender=NEUTER|case=ACCUSATIVE	
στορέσαιμι	στόρεννυμι	VB	person=PERSON_1|number=SINGULAR|voice=ACTIVE	
μυχῷ	μυχός	NN	number=SINGULAR|gender=MASCULINE|case=DATIVE	
θαλάμων	θάλαμος	NN	number=PLURAL|gender=MASCULINE|case=GENITIVE	
εὐπήκτων	εὔπηκτος	ADJ	number=PLURAL|gender=MASCULINE|case=GENITIVE	
δεσπόσυνον	δεσπόσυνος	ADJ	number=SINGULAR|gender=NEUTER|case=ACCUSATIVE	
καί	καί	CONJ	_	
κ̓	ὰν	ADV	_	
ἔργα	ἔργον	NN	number=PLURAL|gender=NEUTER|case=ACCUSATIVE	
διδασκήσαιμι	διδάσκω	VB	person=PERSON_1|number=SINGULAR|voice=ACTIVE	
γυναῖκας	γυνή	NN	number=PLURAL|gender=FEMININE|case=ACCUSATIVE	
ἣ	ὁ	PRON	number=SINGULAR|gender=FEMININE|case=NOMINATIVE	
δὲ	δὲ	CONJ	_	
ἰδοῦσα	εἶδον	VB	number=SINGULAR|mood=PARTICIPLE|voice=ACTIVE|gender=FEMININE|case=NOMINATIVE	
ἤιξ̓	αισσω	VB	person=PERSON_3|number=SINGULAR|mood=INDICATIVE|voice=ACTIVE	
ἠύτε	ἠύτε	CONJ	_	
μαινὰς	μαινάς	NN	number=SINGULAR|gender=FEMININE|case=NOMINATIVE	
ὄρος	ὄρος	NN	number=SINGULAR|gender=NEUTER|case=ACCUSATIVE	
κάτα	κατά	PREP	_	
δάσκιον	δάσκιος	ADJ	number=SINGULAR|gender=NEUTER|case=ACCUSATIVE	
ὕλῃ	ὕλη	NN	number=SINGULAR|gender=FEMININE|case=DATIVE	
ἣ	ὁ	PRON	number=SINGULAR|gender=FEMININE|case=NOMINATIVE	
μὲν	μέν	ADV	_	
ἔπειτα	ἔπειτα	ADV	_	
παῖδ̓	παῖς	NN	number=SINGULAR|gender=MASCULINE|case=ACCUSATIVE	
ἀνὰ	ἀνά	PREP	_	
χερσὶν	χείρ	NN	number=PLURAL|gender=FEMININE|case=DATIVE	
ἑλοῦσα	αἱρέω	VB	number=SINGULAR|mood=PARTICIPLE|voice=ACTIVE|gender=FEMININE|case=NOMINATIVE	
ἑῷ	ἑός	ADJ	number=SINGULAR|gender=MASCULINE|case=DATIVE	
ἐγκάτθετο	ἐγκατατίθεμαι	VB	person=PERSON_3|number=SINGULAR|mood=INDICATIVE	
κόλπῳ	κόλπος	NN	number=SINGULAR|gender=MASCULINE|case=DATIVE	
ἵππους	ἵππος	NN	number=PLURAL|gender=MASCULINE|case=ACCUSATIVE	
δὲ	δὲ	CONJ	_	
προπάροιθεν	προπάροιθεν	ADV	_	
ὑπὸ	ὑπό	PREP	_	
χρυσέοισιν	χρύσεος	ADJ	number=PLURAL|gender=NEUTER|case=DATIVE	
ὄχεσφιν	ὄχος	NN	number=PLURAL|gender=NEUTER|case=DATIVE	
ἔντυεν	τύνω	VB	person=PERSON_3|number=SINGULAR|tense=IMP|mood=INDICATIVE|voice=ACTIVE	
ἀθανάτους	ἀθάνατος	ADJ	number=PLURAL|gender=MASCULINE|case=ACCUSATIVE	
Πολυσημάντωρ	Πολυσημάντωρ	ADJ	number=SINGULAR|gender=MASCULINE|case=NOMINATIVE	
Ἀιδωνευς	Αιδης	NN	number=SINGULAR|gender=MASCULINE|case=NOMINATIVE	
Ἶριν	Ἶρις	NN	number=SINGULAR|gender=FEMININE|case=ACCUSATIVE	
δὲ	δὲ	CONJ	_	
πρῶτον	πρῶτον	ADV	_	
χρυσόπτερον	χρυσόπτερος	ADJ	number=SINGULAR|gender=FEMININE|case=ACCUSATIVE	
ὦρσε	ὄρνυμι	VB	person=PERSON_3|number=SINGULAR|mood=INDICATIVE|voice=ACTIVE	
καλέσσαι	καλέω	VB	mood=INFINITIVE|voice=ACTIVE	
Δήμητῤ	Δήμητηρ	NN	number=SINGULAR|gender=FEMININE|case=ACCUSATIVE	
ἠύκομον	εὔκομος	ADJ	number=SINGULAR|gender=FEMININE|case=ACCUSATIVE	
πολυήρατον	πολυήρατος	ADJ	number=SINGULAR|gender=FEMININE|case=ACCUSATIVE	
εἶδος	εἶδος	NN	number=SINGULAR|gender=NEUTER|case=ACCUSATIVE	
ἔχουσαν	ἔχω	VB	number=SINGULAR|tense=PR|mood=PARTICIPLE|voice=ACTIVE|gender=FEMININE|case=ACCUSATIVE	
αὐτὰρ	αὐτὰρ	CONJ	_	
ἔπειτα	ἔπειτα	ADV	_	
μέλλεν	μέλλω	VB	person=PERSON_3|number=SINGULAR|tense=IMP|mood=INDICATIVE|voice=ACTIVE	
ἄφαρ	ἄφαρ	ADV	_	
ταναοῖσι	ταναός	ADJ	number=PLURAL|gender=MASCULINE|case=DATIVE	
κομήσειν	κομέω	VB	tense=FUTURE|mood=INFINITIVE|voice=ACTIVE	
ἀσταχύεσσιν	ἄσταχυς	NN	number=PLURAL|gender=MASCULINE|case=DATIVE	
ἦρος	ἔαρ	NN	number=SINGULAR|gender=NEUTER|case=GENITIVE	
ἀεξομένοιο	ἀέξω	VB	number=SINGULAR|tense=PR|mood=PARTICIPLE|gender=NEUTER|case=GENITIVE	
πέδῳ	πέδον	NN	number=SINGULAR|gender=NEUTER|case=DATIVE	
δ̓	δε	CONJ	_	
ἄρα	ἄρα	ADV	_	
πίονες	πίων	ADJ	number=PLURAL|gender=MASCULINE|case=NOMINATIVE	
ὄγμοι	ὄγμος	NN	number=PLURAL|gender=MASCULINE|case=NOMINATIVE	
βρισέμεν	βρίθω	VB	tense=FUTURE|mood=INFINITIVE|voice=ACTIVE	
ἀσταχύων	ἄσταχυς	NN	number=PLURAL|gender=MASCULINE|case=GENITIVE	
τὰ	ὁ	PRON	number=PLURAL|gender=NEUTER|case=NOMINATIVE	
δ̓	δε	CONJ	_	
ἐν	ἐν	PREP	_	
ἐλλεδανοῖσι	ἑλλεδανός	NN	number=PLURAL|gender=MASCULINE|case=DATIVE	
δεδέσθαι	δέω	VB	tense=PERF|mood=INFINITIVE	
ταῖς	ὁ	PRON	number=PLURAL|gender=FEMININE|case=DATIVE	
δὲ	δὲ	CONJ	_	
μέτ̓	μέτα	PREP	_	
ἄγγελον	ἄγγελος	NN	number=SINGULAR|gender=MASCULINE|case=ACCUSATIVE	
ἧκε	ἵημι	VB	person=PERSON_3|number=SINGULAR|mood=INDICATIVE|voice=ACTIVE	
βαρύκτυπος	βαρύκτυπος	ADJ	number=SINGULAR|gender=MASCULINE|case=NOMINATIVE	
εὐρύοπα	εὐρύοπα	ADJ	number=SINGULAR|gender=MASCULINE|case=NOMINATIVE	
Ζεὺς	Ζεύς	NN	number=SINGULAR|gender=MASCULINE|case=NOMINATIVE	
Ῥείην	Ῥέα	NN	number=SINGULAR|gender=FEMININE|case=ACCUSATIVE	
ἠύκομον	εὔκομος	ADJ	number=SINGULAR|gender=FEMININE|case=ACCUSATIVE	
Δημήτερα	Δημήτηρ	NN	number=SINGULAR|gender=FEMININE|case=ACCUSATIVE	
κυανόπεπλον	κυανόπεπλος	ADJ	number=SINGULAR|gender=FEMININE|case=ACCUSATIVE	
ἀξέμεναι	ἄγω	VB	tense=FUTURE|mood=INFINITIVE|voice=ACTIVE	
μετὰ	μετά	PREP	_	
φῦλα	φῦλον	NN	number=PLURAL|gender=NEUTER|case=ACCUSATIVE	
θεῶν	θεὸς	NN	number=PLURAL|gender=MASCULINE|case=GENITIVE	
ὑπέδεκτο	ὑποδέχομαι	VB	person=PERSON_3|number=SINGULAR|mood=INDICATIVE	
δὲ	δὲ	CONJ	_	
τιμὰς	τιμή	NN	number=PLURAL|gender=FEMININE|case=ACCUSATIVE	
δωσέμεν	δίδωμι	VB	tense=FUTURE|mood=INFINITIVE|voice=ACTIVE	
ἅς	ἅς	CONJ	_	
κεν	ἄν	ADV	_	
ἕλοιτο	αἱρέω	VB	person=PERSON_3|number=SINGULAR	
μετ̓	μετα	PREP	_	
ἀθανάτοισι	ἀθάνατος	ADJ	number=PLURAL|gender=MASCULINE|case=DATIVE	
θεοῖσι	θεός	NN	number=PLURAL|gender=MASCULINE|case=DATIVE	
εἰναι	εἰναι	VB	tense=PR|mood=INFINITIVE|voice=ACTIVE	
εἰ	εἰ	CONJ	_	
τόν	ὁ	PRON	number=SINGULAR|gender=MASCULINE|case=ACCUSATIVE	
γ̓	γε	ADV	_	
ἐκθρέψαιο	ἐκτρέφω	VB	person=PERSON_2|number=SINGULAR	
καὶ	καί	CONJ	_	
ἥβης	ἥβη	NN	number=SINGULAR|gender=FEMININE|case=GENITIVE	
μέτρον	μέτρον	NN	number=SINGULAR|gender=NEUTER|case=ACCUSATIVE	
ἵκοιτο	ἱκνέομαι	VB	person=PERSON_3|number=SINGULAR	
ῥεῖά	ῥεῖα	ADV	_	
κέ	ἄν	ADV	_	
τίς	τις	PRON	number=SINGULAR|gender=FEMININE|case=NOMINATIVE	
σε	σύ	PRON	person=PERSON_2|number=SINGULAR|case=ACCUSATIVE	
ἰδοῦσα	εἶδον	VB	number=SINGULAR|mood=PARTICIPLE|voice=ACTIVE|gender=FEMININE|case=NOMINATIVE	
γυναικῶν	γυνή	NN	number=PLURAL|gender=FEMININE|case=GENITIVE	
θηλυτεράων	θῆλυς	ADJ	number=PLURAL|gender=FEMININE|case=GENITIVE	
ζηλώσαι	ζηλόω	VB	person=PERSON_3|number=SINGULAR|voice=ACTIVE	
σε	σύ	PRON	person=PERSON_2|number=SINGULAR|case=ACCUSATIVE	
τῆς	ὁ	PRON	number=SINGULAR|gender=FEMININE|case=GENITIVE	
δ̓	δε	CONJ	_	
ἔκλυε	κλύω	VB	person=PERSON_3|number=SINGULAR|tense=IMP|mood=INDICATIVE|voice=ACTIVE	
πότνια	πότνια	NN	number=SINGULAR|gender=FEMININE|case=NOMINATIVE	
μήτηρ	μήτηρ	NN	number=SINGULAR|gender=FEMININE|case=NOMINATIVE	
τὴν	ὁ	PRON	number=SINGULAR|gender=FEMININE|case=ACCUSATIVE	
δὲ	δὲ	CONJ	_	
ἴδον	εἶδον	VB	person=PERSON_3|number=PLURAL|mood=INDICATIVE|voice=ACTIVE	
Κελεοῖο	Κελεός	NN	number=SINGULAR|gender=MASCULINE|case=GENITIVE	
Ἐλευσινίδαο	Ἐλευσινίδαος	ADJ	number=SINGULAR|gender=MASCULINE|case=GENITIVE	
θύγατρες	θυγάτηρ	NN	number=PLURAL|gender=FEMININE|case=NOMINATIVE	
ἐρχόμεναι	ἔρχομαι	VB	number=PLURAL|tense=PR|mood=PARTICIPLE|gender=FEMININE|case=NOMINATIVE	
μεθ̓	μετα	PREP	_	
ὕδωρ	ὕδωρ	NN	number=SINGULAR|gender=NEUTER|case=ACCUSATIVE	
εὐήρυτον	εὐήρυτος	ADJ	number=SINGULAR|gender=NEUTER|case=ACCUSATIVE	
ὄφρα	ὄφρα	CONJ	_	
φέροιεν	φέρω	VB	person=PERSON_3|number=PLURAL|tense=PR|voice=ACTIVE	
κάλπισι	κάλπις	NN	number=PLURAL|gender=FEMININE|case=DATIVE	
χαλκείῃσι	χάλκειος	ADJ	number=PLURAL|gender=FEMININE|case=DATIVE	
φίλα	φίλος	ADJ	number=PLURAL|gender=NEUTER|case=ACCUSATIVE	
πρὸς	πρός	PREP	_	
δώματα	δῶμα	NN	number=PLURAL|gender=NEUTER|case=ACCUSATIVE	
πατρός	πατήρ	NN	number=SINGULAR|gender=MASCULINE|case=GENITIVE	
τέσσαρες	τέσσαρες	ADJ	number=PLURAL|gender=FEMININE|case=NOMINATIVE	
ὥστε	ὥστε	CONJ	_	
θεαί	θεά	NN	number=PLURAL|gender=FEMININE|case=NOMINATIVE	
κουρήιον	κουρήιος	ADJ	number=SINGULAR|gender=NEUTER|case=ACCUSATIVE	
ἄνθος	ἄνθος	NN	number=SINGULAR|gender=NEUTER|case=ACCUSATIVE	
ἔχουσαι	ἔχω	VB	number=PLURAL|tense=PR|mood=PARTICIPLE|voice=ACTIVE|gender=FEMININE|case=NOMINATIVE	
Καλλιδίκη	Καλλιδίκη	NN	number=SINGULAR|gender=FEMININE|case=NOMINATIVE	
καὶ	καί	CONJ	_	
Κλεισιδίκη	Κλεισιδίκη	NN	number=SINGULAR|gender=FEMININE|case=NOMINATIVE	
Δημώ	Δημώ	NN	number=SINGULAR|gender=FEMININE|case=NOMINATIVE	
τ̓	τε	CONJ	_	
ἐρόεσσα	ἐρόεις	ADJ	number=SINGULAR|gender=FEMININE|case=NOMINATIVE	
Καλλιθόη	Καλλιθόη	NN	number=SINGULAR|gender=FEMININE|case=NOMINATIVE	
θ̓	τε	CONJ	_	
ἣ	ὅς	PRON	number=SINGULAR|gender=FEMININE|case=NOMINATIVE	
τῶν	ὁ	PRON	number=PLURAL|gender=FEMININE|case=GENITIVE	
προγενεστάτη	προγενής	ADJ	number=SINGULAR|gender=FEMININE|case=NOMINATIVE|degree=SUPERLATIVE	
ἦεν	εἰμί	VB	person=PERSON_3|number=SINGULAR|tense=IMP|mood=INDICATIVE|voice=ACTIVE	
ἁπασῶν	ἅπας	ADJ	number=PLURAL|gender=FEMININE|case=GENITIVE	
ἣ	ὁ	PRON	number=SINGULAR|gender=FEMININE|case=NOMINATIVE	
δ̓	δε	CONJ	_	
ἀποτηλοῦ	ἀποτηλοῦ	ADV	_	
ἔργοις	ἔργον	NN	number=PLURAL|gender=NEUTER|case=DATIVE	
θεῶν	θεὸς	NN	number=PLURAL|gender=MASCULINE|case=GENITIVE	
μακάρων	μάκαρος	ADJ	number=PLURAL|gender=MASCULINE|case=GENITIVE	
δεινὴν	δεινός	ADJ	number=SINGULAR|gender=FEMININE|case=ACCUSATIVE	
μητίσετο	μητίομαι	VB	person=PERSON_3|number=SINGULAR|mood=INDICATIVE	
βουλήν	βουλή	NN	number=SINGULAR|gender=FEMININE|case=ACCUSATIVE	
χαῖρε	χαίρω	VB	person=PERSON_2|number=SINGULAR|tense=PR|mood=IMPERATIVE|voice=ACTIVE	
γύναι	γυνή	NN	number=SINGULAR|gender=FEMININE|case=VOCATIVE	
ἐπεὶ	ἐπεί	CONJ	_	
οὔ	οὐ	ADV	_	
σε	σύ	PRON	person=PERSON_2|number=SINGULAR|case=ACCUSATIVE	
κακῶν	κακός	ADJ	number=PLURAL|gender=MASCULINE|case=GENITIVE	
ἄπ̓	ἄπο	PREP	_	
ἔολπα	ἔλπω	VB	person=PERSON_1|number=SINGULAR|tense=PERF|mood=INDICATIVE|voice=ACTIVE	
τοκήων	τοκεύς	NN	number=PLURAL|gender=MASCULINE|case=GENITIVE	
ἔμμεναι	εἰμί	VB	tense=PR|mood=INFINITIVE|voice=ACTIVE	
ἀλλ̓	ἀλλα	CONJ	_	
ἀγαθῶν	ἀγαθός	ADJ	number=PLURAL|gender=MASCULINE|case=GENITIVE	
στερεῶς	στερεός	ADJ	_	
δ̓	δε	CONJ	_	
ἠναίνετο	ἀναίνομαι	VB	person=PERSON_3|number=SINGULAR|tense=IMP|mood=INDICATIVE	
μύθους	μῦθος	NN	number=PLURAL|gender=MASCULINE|case=ACCUSATIVE	
ὀξὺ	ὀξύς	ADJ	number=SINGULAR|gender=NEUTER|case=NOMINATIVE	
δέ	δέ	CONJ	_	
μιν	μιν	PRON	person=PERSON_3|number=SINGULAR|gender=FEMININE|case=ACCUSATIVE	
κραδίην	καρδία	NN	number=SINGULAR|gender=FEMININE|case=ACCUSATIVE	
ἄχος	ἄχος	NN	number=SINGULAR|gender=NEUTER|case=NOMINATIVE	
ἔλλαβεν	ἐν-λαμβάνω	VB	person=PERSON_3|number=SINGULAR|mood=INDICATIVE|voice=ACTIVE	
ἀμφὶ	ἀμφί	PREP	_	
δὲ	δὲ	CONJ	_	
χαίταις	χαίτη	NN	number=PLURAL|gender=FEMININE|case=DATIVE	
ἀμβροσίαις	ἀμβρόσιος	ADJ	number=PLURAL|gender=FEMININE|case=DATIVE	
κρήδεμνα	κρήδεμνον	NN	number=PLURAL|gender=NEUTER|case=ACCUSATIVE	
δαΐζετο	δαίζω	VB	person=PERSON_3|number=SINGULAR|tense=IMP|mood=INDICATIVE	
χερσὶ	χείρ	NN	number=PLURAL|gender=FEMININE|case=DATIVE	
φίλῃσι	φίλος	ADJ	number=PLURAL|gender=FEMININE|case=DATIVE	
κυάνεον	κυάνεος	ADJ	number=SINGULAR|gender=NEUTER|case=ACCUSATIVE	
δὲ	δὲ	CONJ	_	
κάλυμμα	κάλυμμα	NN	number=SINGULAR|gender=NEUTER|case=ACCUSATIVE	
κατ̓	κατα	PREP	_	
ἀμφοτέρων	ἀμφότερος	ADJ	number=PLURAL|gender=MASCULINE|case=GENITIVE	
βάλετ̓	βάλλω	VB	person=PERSON_3|number=SINGULAR|mood=INDICATIVE	
ὤμων	ὦμος	NN	number=PLURAL|gender=MASCULINE|case=GENITIVE	
σεύατο	σεύω	VB	person=PERSON_3|number=SINGULAR|mood=INDICATIVE	
δ̓	δε	CONJ	_	
ὥστ̓	ὥστε	CONJ	_	
οἰωνός	οἰωνός	NN	number=SINGULAR|gender=MASCULINE|case=NOMINATIVE	
ἐπὶ	ἐπί	PREP	_	
τραφερήν	τραφερός	ADJ	number=SINGULAR|gender=FEMININE|case=ACCUSATIVE	
τε	τε	CONJ	_	
καὶ	καί	CONJ	_	
ὑγρὴν	ὑγρός	ADJ	number=SINGULAR|gender=FEMININE|case=ACCUSATIVE	
μαιομένη	μαίομαι	VB	number=SINGULAR|tense=PR|mood=PARTICIPLE|gender=FEMININE|case=NOMINATIVE	
νήιδες	νῆις	ADJ	number=PLURAL|gender=MASCULINE|case=VOCATIVE	
ἄνθρωποι	ἄνθρωπος	NN	number=PLURAL|gender=MASCULINE|case=VOCATIVE	
καὶ	καί	CONJ	_	
ἀφράδμονες	ἀφράδμων	ADJ	number=PLURAL|gender=MASCULINE|case=VOCATIVE	
οὔ	οὐ	ADV	_	
-τ̓	τε	CONJ	_	
ἀγαθοῖο	ἀγαθός	ADJ	number=SINGULAR|gender=NEUTER|case=GENITIVE	
αἶσαν	αἶσα	NN	number=SINGULAR|gender=FEMININE|case=ACCUSATIVE	
ἐπερχομένου	ἐπέρχομαι	VB	number=SINGULAR|tense=PR|mood=PARTICIPLE|gender=NEUTER|case=GENITIVE	
προγνώμεναι	προγιγνώσκω	VB	number=PLURAL|mood=PARTICIPLE|gender=FEMININE|case=NOMINATIVE	
οὔτε	οὐτε	CONJ	_	
κακοῖο	κακός	ADJ	number=SINGULAR|gender=NEUTER|case=GENITIVE	
καὶ	καί	CONJ	_	
σὺ	σύ	PRON	person=PERSON_2|number=SINGULAR|case=NOMINATIVE	
γὰρ	γάρ	ADV	_	
ἀφραδίῃσι	ἀφραδία	NN	number=PLURAL|gender=FEMININE|case=DATIVE	
τεῇς	τεός	ADJ	number=PLURAL|gender=FEMININE|case=DATIVE	
νήκεστον	νήκεστος	ADJ	number=SINGULAR|gender=NEUTER|case=ACCUSATIVE	
ἀάσθης	ἀάω	VB	person=PERSON_2|number=SINGULAR|mood=INDICATIVE|voice=PASSIVE	
οὕτω	οὕτως	ADV	_	
δεῦῤ	δεῦρο	ADV	_	
ἱκόμην	ἱκνέομαι	VB	person=PERSON_1|number=SINGULAR|mood=INDICATIVE	
ἀλαλημένη	ἀλάλημαι	VB	number=SINGULAR|tense=PR|mood=PARTICIPLE|gender=FEMININE|case=NOMINATIVE	
οὐδέ	οὐδέ	CONJ	_	
τι	τις	PRON	number=SINGULAR|gender=NEUTER|case=ACCUSATIVE	
οἶδα	οἶδα	VB	person=PERSON_1|number=SINGULAR|tense=PERF|mood=INDICATIVE|voice=ACTIVE	
ἥ	ἥ	ADV	_	
τις	τις	PRON	number=SINGULAR|gender=FEMININE|case=NOMINATIVE	
δὴ	δή	ADV	_	
γαῖ̓	γαῖα	NN	number=SINGULAR|gender=FEMININE|case=NOMINATIVE	
ἐστι	εἰμί	VB	person=PERSON_3|number=SINGULAR|tense=PR|mood=INDICATIVE|voice=ACTIVE	
καὶ	καί	CONJ	_	
οἵ	ὁ		number=PLURAL|gender=MASCULINE|case=NOMINATIVE	
τινες	τις	PRON	number=PLURAL|gender=MASCULINE|case=NOMINATIVE	
ἐγγεγάασιν	ἐγγίγνομαι	VB	person=PERSON_3|number=PLURAL|tense=PERF|mood=INDICATIVE|voice=ACTIVE	
τιμὴ	τιμή	NN	number=SINGULAR|gender=FEMININE|case=NOMINATIVE	
δ̓	δε	CONJ	_	
ἄφθιτος	ἄφθιτος	ADJ	number=SINGULAR|gender=FEMININE|case=NOMINATIVE	
αἰὲν	ἀεί	ADV	_	
ἐπέσσεται	ἔπειμι	VB	person=PERSON_3|number=SINGULAR|tense=FUTURE|mood=INDICATIVE|voice=ACTIVE	
οὕνεκα	οὕνεκα	CONJ	_	
γούνων	γόνυ	NN	number=PLURAL|gender=NEUTER|case=GENITIVE	
ἡμετέρων	ἡμέτερος	ADJ	number=PLURAL|gender=NEUTER|case=GENITIVE	
ἐπέβη	ἐπιβαίνω	VB	person=PERSON_3|number=SINGULAR|mood=INDICATIVE|voice=ACTIVE	
καὶ	καί	CONJ	_	
ἐν	ἐν	PREP	_	
ἀγκοίνῃσιν	ἄγκοινα	NN	number=PLURAL|gender=FEMININE|case=DATIVE	
ἴαυσεν	ἰαύω	VB	person=PERSON_3|number=SINGULAR|mood=INDICATIVE|voice=ACTIVE	
ἄλλ̓	ἀλλά	CONJ	_	
ἴθι	εἶμι	VB	person=PERSON_2|number=SINGULAR|tense=PR|mood=IMPERATIVE|voice=ACTIVE	
μηδ̓	μήδε	CONJ	_	
ἀτέλεστον	ἀτέλεστος	ADJ	number=SINGULAR|gender=NEUTER|case=NOMINATIVE	
ἐμὸν	ἐμός	ADJ	number=SINGULAR|gender=NEUTER|case=NOMINATIVE	
ἔπος	ἔπος	NN	number=SINGULAR|gender=NEUTER|case=NOMINATIVE	
ἐκ	ἐκ	PREP	_	
Διὸς	Ζεύς	NN	number=SINGULAR|gender=MASCULINE|case=GENITIVE	
ἔστω	εἰμί	VB	person=PERSON_3|number=SINGULAR|tense=PR|mood=IMPERATIVE|voice=ACTIVE	
ἀλλ̓	ἀλλα	CONJ	_	
ἄγ̓	ἄγω	VB	person=PERSON_2|number=SINGULAR|tense=PR|mood=IMPERATIVE|voice=ACTIVE	
Ἐλευσῖνος	Ἐλευσίς	NN	number=SINGULAR|gender=FEMININE|case=GENITIVE	
θυοέσσης	θυόεις	ADJ	number=SINGULAR|gender=FEMININE|case=GENITIVE	
δῆμον	δῆμος	NN	number=SINGULAR|gender=MASCULINE|case=ACCUSATIVE	
ἔχουσα	ἔχω	VB	number=SINGULAR|tense=PR|mood=PARTICIPLE|voice=ACTIVE|gender=FEMININE|case=NOMINATIVE	
καὶ	καί	CONJ	_	
Πάρον	Πάρος	NN	number=SINGULAR|gender=FEMININE|case=ACCUSATIVE	
ἀμφιρύτην	ἀμφίρυτος	ADJ	number=SINGULAR|gender=FEMININE|case=ACCUSATIVE	
Ἀντρῶνά	Ἀντρών	NN	number=SINGULAR|gender=MASCULINE|case=ACCUSATIVE	
τε	τε	CONJ	_	
πετρήεντα	πετρήεις	ADJ	number=SINGULAR|gender=MASCULINE|case=ACCUSATIVE	
πότνια	πότνια	NN	number=SINGULAR|gender=FEMININE|case=VOCATIVE	
ἀγλαόδωῤ	ἀγλαόδωρος	ADJ	number=SINGULAR|gender=FEMININE|case=VOCATIVE	
ὡρηφόρε	ὡρηφόρος	ADJ	number=SINGULAR|gender=FEMININE|case=VOCATIVE	
Δηοῖ	Δηώ	NN	number=SINGULAR|case=GENITIVE	
ἄνασσα	ἄνασσα	NN	number=SINGULAR|gender=FEMININE|case=VOCATIVE	
αὐτὴ	αὐτός	PRON	number=SINGULAR|gender=FEMININE|case=VOCATIVE	
καὶ	καί	CONJ	_	
κούρη	κόρη	NN	number=SINGULAR|gender=FEMININE|case=VOCATIVE	
περικαλλὴς	περικαλλής	ADJ	number=SINGULAR|gender=FEMININE|case=NOMINATIVE	
Περσεφόνεια	Περσεφόνεια	NN	number=SINGULAR|gender=FEMININE|case=VOCATIVE	
καὶ	καί	CONJ	_	
σύ	σύ	PRON	person=PERSON_2|number=SINGULAR|case=NOMINATIVE	
γύναι	γυνή	NN	number=SINGULAR|gender=FEMININE|case=VOCATIVE	
μάλα	μάλα	ADV	_	
χαῖρε	χαίρω	VB	person=PERSON_2|number=SINGULAR|tense=PR|mood=IMPERATIVE|voice=ACTIVE	
θεοὶ	θεός	NN	number=PLURAL|gender=MASCULINE|case=NOMINATIVE	
δέ	δέ	CONJ	_	
τοι	σύ	PRON	person=PERSON_2|number=SINGULAR|case=DATIVE	
ἐσθλὰ	ἐσθλός	ADJ	number=PLURAL|gender=NEUTER|case=ACCUSATIVE	
πόροιεν	πόρω	VB	person=PERSON_3|number=PLURAL|voice=ACTIVE	
τοῦ	ὁ	PRON	number=SINGULAR|gender=NEUTER|case=GENITIVE	
καὶ	καί	CONJ	_	
ἀπὸ	ἀπό	PREP	_	
ῥίζης	ῥίζα	NN	number=SINGULAR|gender=FEMININE|case=GENITIVE	
ἑκατὸν	ἑκατὸς	PRON	number=SINGULAR|gender=NEUTER|case=ACCUSATIVE	
κάρα	κάρα	NN	number=SINGULAR|gender=NEUTER|case=ACCUSATIVE	
ἐξεπεφύκει	ἐκφύω	VB	person=PERSON_3|number=SINGULAR|tense=PLUSQUAMPERFECT|mood=INDICATIVE|voice=ACTIVE	
ῥίμφα	ῥίμφα	ADV	_	
δὲ	δὲ	CONJ	_	
πατρὸς	πατήρ	NN	number=SINGULAR|gender=MASCULINE|case=GENITIVE	
ἵκοντο	ἱκνέομαι	VB	person=PERSON_3|number=PLURAL|mood=INDICATIVE	
μέγαν	μέγας	ADJ	number=SINGULAR|gender=MASCULINE|case=ACCUSATIVE	
δόμον	δόμος	NN	number=SINGULAR|gender=MASCULINE|case=ACCUSATIVE	
ὦκα	ὦκα	ADV	_	
δὲ	δὲ	CONJ	_	
μητρὶ	μήτηρ	NN	number=SINGULAR|gender=FEMININE|case=DATIVE	
ἔννεπον	ἐνέπω	VB	person=PERSON_3|number=PLURAL|tense=IMP|mood=INDICATIVE|voice=ACTIVE	
ὡς	ὡς	CONJ	_	
εἶδόν	εἶδον	VB	person=PERSON_3|number=PLURAL|mood=INDICATIVE|voice=ACTIVE	
τε	τε	CONJ	_	
καὶ	καί	CONJ	_	
ἔκλυον	κλύω	VB	person=PERSON_3|number=PLURAL|mood=INDICATIVE|voice=ACTIVE	
ἑῷ	ἑός	ADJ	number=SINGULAR|gender=NEUTER|case=DATIVE	
δ̓	δε	CONJ	_	
ἐπένευσε	ἐπινεύω	VB	person=PERSON_3|number=SINGULAR|mood=INDICATIVE|voice=ACTIVE	
κάρητι	κάρα	NN	number=SINGULAR|gender=NEUTER|case=DATIVE	
δεῦρο	δεῦρο	ADV	_	
τέκος	τέκος	NN	number=SINGULAR|gender=NEUTER|case=VOCATIVE	
καλέει	καλέω	VB	person=PERSON_3|number=SINGULAR|tense=PR|mood=INDICATIVE|voice=ACTIVE	
σε	σύ	PRON	person=PERSON_2|number=SINGULAR|case=ACCUSATIVE	
βαρύκτυπος	βαρύκτυπος	ADJ	number=SINGULAR|gender=MASCULINE|case=NOMINATIVE	
εὐρύοπα	εὐρύοπα	ADJ	number=SINGULAR|gender=MASCULINE|case=NOMINATIVE	
Ζεὺς	Ζεύς	NN	number=SINGULAR|gender=MASCULINE|case=NOMINATIVE	
ἐλθέμεναι	ἔρχομαι	VB	mood=INFINITIVE|voice=ACTIVE	
μετὰ	μετά	PREP	_	
φῦλα	φῦλον	NN	number=PLURAL|gender=NEUTER|case=ACCUSATIVE	
θεῶν	θεὸς	NN	number=PLURAL|gender=MASCULINE|case=GENITIVE	
ὑπέδεκτο	ὑποδέχομαι	VB	person=PERSON_3|number=SINGULAR|mood=INDICATIVE	
δὲ	δὲ	CONJ	_	
τιμὰς	τιμή	NN	number=PLURAL|gender=FEMININE|case=ACCUSATIVE	
δωσέμεν	δίδωμι	VB	tense=FUTURE|mood=INFINITIVE|voice=ACTIVE	
ἅς	ἅς	CONJ	_	
κ̓	ὰν	ADV	_	
ἐθέλῃσθα	ἐθέλω	VB	person=PERSON_2|number=SINGULAR|tense=PR|mood=SUBJUNCTIVE|voice=ACTIVE	
μετ̓	μετα	PREP	_	
ἀθανάτοισι	ἀθάνατος	ADJ	number=PLURAL|gender=MASCULINE|case=DATIVE	
θεοῖσι	θεός	NN	number=PLURAL|gender=MASCULINE|case=DATIVE	
εἰναι	εἰναι	VB	tense=PR|mood=INFINITIVE|voice=ACTIVE	
αἶψα	αἶψα	ADV	_	
δὲ	δὲ	CONJ	_	
καρπὸν	καρπός	NN	number=SINGULAR|gender=MASCULINE|case=ACCUSATIVE	
ἀνῆκεν	ἀνίημι	VB	person=PERSON_3|number=SINGULAR|mood=INDICATIVE|voice=ACTIVE	
ἀρουράων	ἄρουρα	NN	number=PLURAL|gender=FEMININE|case=GENITIVE	
ἐριβώλων	ἐρίβωλος	ADJ	number=PLURAL|gender=FEMININE|case=GENITIVE	
αἰνότατον	αἰνός	ADJ	number=SINGULAR|gender=MASCULINE|case=ACCUSATIVE|degree=SUPERLATIVE	
δ̓	δε	CONJ	_	
ἐνιαυτὸν	ἐνιαυτός	NN	number=SINGULAR|gender=MASCULINE|case=ACCUSATIVE	
ἐπὶ	ἐπί	PREP	_	
χθόνα	χθών	NN	number=SINGULAR|gender=FEMININE|case=ACCUSATIVE	
πουλυβότειραν	πουλυβότειρα	ADJ	number=SINGULAR|gender=FEMININE|case=ACCUSATIVE	
ποίησ̓	ποιέω	VB	person=PERSON_3|number=SINGULAR|mood=INDICATIVE|voice=ACTIVE	
ἀνθρώποις	ἄνθρωπος	NN	number=PLURAL|gender=MASCULINE|case=DATIVE	
καὶ	καί	CONJ	_	
κύντατον	κύντερος	ADJ	number=SINGULAR|gender=MASCULINE|case=ACCUSATIVE	
χαλεποὶ	χαλεπός	ADJ	number=PLURAL|gender=MASCULINE|case=NOMINATIVE	
δὲ	δὲ	CONJ	_	
θεοὶ	θεός	NN	number=PLURAL|gender=MASCULINE|case=NOMINATIVE	
θνητοῖσιν	θνητός	ADJ	number=PLURAL|gender=MASCULINE|case=DATIVE	
ὁρᾶσθαι	ὁράω	VB	tense=PR|mood=INFINITIVE	
εἰσὶ	εἰμί	VB	person=PERSON_3|number=PLURAL|tense=PR|mood=INDICATIVE|voice=ACTIVE	
ἐννῆμαρ	ἐννῆμαρ	ADV	_	
μὲν	μέν	ADV	_	
ἔπειτα	ἔπειτα	ADV	_	
κατὰ	κατά	PREP	_	
χθόνα	χθών	NN	number=SINGULAR|gender=FEMININE|case=ACCUSATIVE	
πότνια	πότνια	NN	number=SINGULAR|gender=FEMININE|case=NOMINATIVE	
Δηὼ	Δηώ	NN	number=SINGULAR|gender=FEMININE|case=NOMINATIVE	
στρωφᾶτ̓	στρωφάω	VB	person=PERSON_3|number=SINGULAR|mood=INDICATIVE	
αἰθομένας	αἴθω	VB	number=PLURAL|tense=PR|mood=PARTICIPLE|gender=FEMININE|case=ACCUSATIVE	
δαΐδας	δαίς	NN	number=PLURAL|gender=FEMININE|case=ACCUSATIVE	
μετὰ	μετά	PREP	_	
χερσὶν	χείρ	NN	number=PLURAL|gender=FEMININE|case=DATIVE	
ἔχουσα	ἔχω	VB	number=SINGULAR|tense=PR|mood=PARTICIPLE|voice=ACTIVE|gender=FEMININE|case=NOMINATIVE	
οὐδέ	οὐδέ	CONJ	_	
ποτ̓	ποτε	ADV	_	
ἀμβροσίης	ἀμβροσία	NN	number=SINGULAR|gender=FEMININE|case=GENITIVE	
καὶ	καί	CONJ	_	
νέκταρος	νέκταρ	NN	number=SINGULAR|gender=NEUTER|case=GENITIVE	
ἡδυπότοιο	ἡδύποτος	ADJ	number=SINGULAR|gender=NEUTER|case=GENITIVE	
πάσσατ̓	πατέομαι	VB	person=PERSON_3|number=SINGULAR|mood=INDICATIVE	
ἀκηχεμένη	ἀχεύω	VB	number=SINGULAR|tense=PERF|mood=PARTICIPLE|voice=PASSIVE|gender=FEMININE|case=NOMINATIVE	
οὐδὲ	οὐδὲ	CONJ	_	
χρόα	χρώς	NN	number=SINGULAR|gender=MASCULINE|case=ACCUSATIVE	
βάλλετο	βάλλω	VB	person=PERSON_3|number=SINGULAR|tense=IMP|mood=INDICATIVE	
λουτροῖς	λουτρόν	NN	number=PLURAL|gender=NEUTER|case=DATIVE	
ἣ	ὁ	PRON	number=SINGULAR|gender=FEMININE|case=NOMINATIVE	
δ̓	δε	CONJ	_	
αἰνὸν	αἰνός	ADJ	number=SINGULAR|gender=MASCULINE|case=ACCUSATIVE	
ἔχει	ἔχω	VB	person=PERSON_3|number=SINGULAR|tense=PR|mood=INDICATIVE|voice=ACTIVE	
χόλον	χόλος	NN	number=SINGULAR|gender=MASCULINE|case=ACCUSATIVE	
οὐδὲ	οὐδὲ	CONJ	_	
θεοῖσι	θεός	NN	number=PLURAL|gender=MASCULINE|case=DATIVE	
μίσγεται	μίγνυμι	VB	person=PERSON_3|number=SINGULAR|tense=PR|mood=INDICATIVE	
ἀλλ̓	ἀλλα	CONJ	_	
ἀπάνευθε	ἀπάνευθε	PREP	_	
θυώδεος	θυώδης	ADJ	number=SINGULAR|gender=MASCULINE|case=GENITIVE	
ἔνδοθι	ἔνδοθι	ADV	_	
νηοῦ	ναός	NN	number=SINGULAR|gender=MASCULINE|case=GENITIVE	
ἧσται	ἧμαι	VB	person=PERSON_3|number=SINGULAR|tense=PERF|mood=INDICATIVE	
Ἐλευσῖνος	Ἐλευσίς	NN	number=SINGULAR|gender=FEMININE|case=GENITIVE	
κραναὸν	κραναός	ADJ	number=SINGULAR|gender=NEUTER|case=ACCUSATIVE	
πτολίεθρον	πτολίεθρον	NN	number=SINGULAR|gender=NEUTER|case=ACCUSATIVE	
ἔχουσα	ἔχω	VB	number=SINGULAR|tense=PR|mood=PARTICIPLE|voice=ACTIVE|gender=FEMININE|case=NOMINATIVE	
ἀτὰρ	ἀτὰρ	CONJ	_	
ξανθὴ	ξανθός	ADJ	number=SINGULAR|gender=FEMININE|case=NOMINATIVE	
Δημήτηρ	Δημήτηρ	NN	number=SINGULAR|gender=FEMININE|case=NOMINATIVE	
ἔνθα	ἔνθα	ADV	_	
καθεζομένη	κατά-ἕζομαι	VB	number=SINGULAR|tense=PR|mood=PARTICIPLE|gender=FEMININE|case=NOMINATIVE	
μακάρων	μάκαρος	ADJ	number=PLURAL|gender=MASCULINE|case=GENITIVE	
ἀπὸ	ἀπό	PREP	_	
νόσφιν	νόσφιν	ADV	_	
ἁπάντων	ἅπας	ADJ	number=PLURAL|gender=MASCULINE|case=GENITIVE	
μίμνε	μίμνω	VB	person=PERSON_3|number=SINGULAR|tense=IMP|mood=INDICATIVE|voice=ACTIVE	
πόθῳ	πόθος	NN	number=SINGULAR|gender=MASCULINE|case=DATIVE	
μινύθουσα	μινύθω	VB	number=SINGULAR|tense=PR|mood=PARTICIPLE|voice=ACTIVE|gender=FEMININE|case=NOMINATIVE	
βαθυζώνοιο	βαθύζωνος	ADJ	number=SINGULAR|gender=FEMININE|case=GENITIVE	
θυγατρός	θυγάτηρ	NN	number=SINGULAR|gender=FEMININE|case=GENITIVE	
οἳ	ὁ	PRON	number=PLURAL|gender=MASCULINE|case=NOMINATIVE	
μὲν	μέν	ADV	_	
ἔπειτα	ἔπειτα	CONJ	_	
νηὶ	ναῦς	NN	number=SINGULAR|gender=FEMININE|case=DATIVE	
θοῇ	θοός	ADJ	number=SINGULAR|gender=FEMININE|case=DATIVE	
Θόρικόνδε	Θόρικόνδε	ADV	_	
κατέσχεθον	κατασχεθεῖν	VB	person=PERSON_3|number=PLURAL|mood=INDICATIVE|voice=ACTIVE	
ἔνθα	ἔνθα	ADV	_	
γυναῖκες	γυνή	NN	number=PLURAL|gender=FEMININE|case=NOMINATIVE	
ἠπείρου	ἤπειρος	NN	number=SINGULAR|gender=FEMININE|case=GENITIVE	
ἐπέβησαν	ἐπιβαίνω	VB	person=PERSON_3|number=PLURAL|mood=INDICATIVE|voice=ACTIVE	
ἀολλέες	ἀολλής	ADJ	number=PLURAL|gender=FEMININE|case=NOMINATIVE	
ἠδὲ	ἠδέ	CONJ	_	
καὶ	καὶ	ADV	_	
αὐτοί	αὐτός	PRON	number=PLURAL|gender=MASCULINE|case=NOMINATIVE	
δεῖπνόν	δεῖπνον	NN	number=SINGULAR|gender=NEUTER|case=ACCUSATIVE	
τ̓	τε	CONJ	_	
ἐπηρτύνοντο	ἐπί-ἀρτύνω	VB	person=PERSON_3|number=PLURAL|tense=IMP|mood=INDICATIVE	
παρὰ	παρά	PREP	_	
πρυμνήσια	πρυμνήσιος	ADJ	number=PLURAL|gender=NEUTER|case=ACCUSATIVE	
νηός	ναῦς	NN	number=SINGULAR|gender=FEMININE|case=GENITIVE	
ὀδμὴ	ὀσμή	NN	number=SINGULAR|gender=FEMININE|case=NOMINATIVE	
δ̓	δε	CONJ	_	
ἱμερόεσσα	ἱμερόεις	ADJ	number=SINGULAR|gender=FEMININE|case=NOMINATIVE	
θυηέντων	θυήεις	ADJ	number=PLURAL|gender=MASCULINE|case=GENITIVE	
ἀπὸ	ἀπό	PREP	_	
πέπλων	πέπλος	NN	number=PLURAL|gender=MASCULINE|case=GENITIVE	
σκίδνατο	σκίδνημι	VB	person=PERSON_3|number=SINGULAR|tense=IMP|mood=INDICATIVE	
τῆλε	τῆλε	ADV	_	
δὲ	δὲ	CONJ	_	
φέγγος	φέγγος	NN	number=SINGULAR|gender=NEUTER|case=NOMINATIVE	
ἀπὸ	ἀπό	PREP	_	
χροὸς	χρώς	NN	number=SINGULAR|gender=MASCULINE|case=GENITIVE	
ἀθανάτοιο	ἀθάνατος	ADJ	number=SINGULAR|gender=MASCULINE|case=GENITIVE	
λάμπε	λάμπω	VB	person=PERSON_3|number=SINGULAR|tense=IMP|mood=INDICATIVE|voice=ACTIVE	
θεᾶς	θεά	NN	number=SINGULAR|gender=FEMININE|case=GENITIVE	
ξανθαὶ	ξανθός	ADJ	number=PLURAL|gender=FEMININE|case=NOMINATIVE	
δὲ	δὲ	CONJ	_	
κόμαι	κόμη	NN	number=PLURAL|gender=FEMININE|case=NOMINATIVE	
κατενήνοθεν	κατά-ἐνήνοθε	VB	person=PERSON_3|number=PLURAL|tense=PLUSQUAMPERFECT|mood=INDICATIVE|voice=ACTIVE	
ὤμους	ὦμος	NN	number=PLURAL|gender=MASCULINE|case=ACCUSATIVE	
αὐγῆς	αὐγή	NN	number=SINGULAR|gender=FEMININE|case=GENITIVE	
δ̓	δε	CONJ	_	
ἐπλήσθη	πίμπλημι	VB	person=PERSON_3|number=SINGULAR|mood=INDICATIVE|voice=PASSIVE	
πυκινὸς	πυκινός	ADJ	number=SINGULAR|gender=MASCULINE|case=NOMINATIVE	
δόμος	δόμος	NN	number=SINGULAR|gender=MASCULINE|case=NOMINATIVE	
ἀστεροπῆς	ἀστεροπή	NN	number=SINGULAR|gender=FEMININE|case=GENITIVE	
ὥς	ὡς	CONJ	_	
οὐδέ	οὐδέ	CONJ	_	
τις	τις	PRON	number=SINGULAR|gender=MASCULINE|case=NOMINATIVE	
ἀνδρῶν	ἀνήρ	NN	number=PLURAL|gender=MASCULINE|case=GENITIVE	
εἰσορόων	εἰσοράω	VB	number=SINGULAR|tense=PR|mood=PARTICIPLE|voice=ACTIVE|gender=MASCULINE|case=NOMINATIVE	
γίγνωσκε	γιγνώσκω	VB	person=PERSON_3|number=SINGULAR|tense=IMP|mood=INDICATIVE|voice=ACTIVE	
βαθυζώνων	βαθύζωνος	ADJ	number=PLURAL|gender=FEMININE|case=GENITIVE	
τε	τε	CONJ	_	
γυναικῶν	γυνή	NN	number=PLURAL|gender=FEMININE|case=GENITIVE	
πρίν	πρίν	CONJ	_	
γ̓	γε	ADV	_	
ὅτε	ὅτε	ADV	_	
δὴ	δή	ADV	_	
Κελεοῖο	Κελεός	NN	number=SINGULAR|gender=MASCULINE|case=GENITIVE	
δαΐφρονος	δαίφρων	ADJ	number=SINGULAR|case=GENITIVE	
ἵκετο	ἱκνέομαι	VB	person=PERSON_3|number=SINGULAR|mood=INDICATIVE	
δῶμα	δῶμα	NN	number=SINGULAR|gender=NEUTER|case=ACCUSATIVE	
ὃς	ὅς	PRON	number=SINGULAR|gender=MASCULINE|case=NOMINATIVE	
τότ̓	τότε	ADV	_	
Ἐλευσῖνος	Ἐλευσίς	NN	number=SINGULAR|gender=FEMININE|case=GENITIVE	
θυοέσσης	θυόεις	ADJ	number=SINGULAR|gender=FEMININE|case=GENITIVE	
κοίρανος	κοίρανος	NN	number=SINGULAR|gender=MASCULINE|case=NOMINATIVE	
ἦεν	εἰμί	VB	person=PERSON_3|number=SINGULAR|tense=IMP|mood=INDICATIVE|voice=ACTIVE	
οἳ	ὁ	PRON	number=PLURAL|gender=MASCULINE|case=NOMINATIVE	
δὲ	δὲ	CONJ	_	
μάλ̓	μάλα	ADV	_	
αἶψ̓	αἶψα	ADV	_	
ἐπίθοντο	πείθω	VB	person=PERSON_3|number=PLURAL|mood=INDICATIVE	
καὶ	καί	CONJ	_	
ἔκλυον	ἐκλύω	VB	person=PERSON_3|number=PLURAL|tense=IMP|mood=INDICATIVE|voice=ACTIVE	
αὐδήσαντος	αὐδάω	VB	number=SINGULAR|mood=PARTICIPLE|voice=ACTIVE|gender=NEUTER|case=GENITIVE	
τεῦχον	τεύχω	VB	person=PERSON_3|number=PLURAL|tense=IMP|mood=INDICATIVE|voice=ACTIVE	
δ̓	δε	CONJ	_	
ὡς	ὡς	CONJ	_	
ἐπέτελλ̓	ἐπιτέλλω	VB	person=PERSON_3|number=SINGULAR|tense=IMP|mood=INDICATIVE|voice=ACTIVE	
ὣς	ὡς	CONJ	_	
εἰποῦσα	εἶπον	VB	number=SINGULAR|mood=PARTICIPLE|voice=ACTIVE|gender=FEMININE|case=NOMINATIVE	
θεὰ	θεά	NN	number=SINGULAR|gender=FEMININE|case=NOMINATIVE	
μέγεθος	μέγεθος	NN	number=SINGULAR|gender=NEUTER|case=ACCUSATIVE	
καὶ	καί	CONJ	_	
εἶδος	εἶδος	NN	number=SINGULAR|gender=NEUTER|case=ACCUSATIVE	
ἄμειψε	ἀμείβω	VB	person=PERSON_3|number=SINGULAR|mood=INDICATIVE|voice=ACTIVE	
γῆρας	γῆρας	NN	number=SINGULAR|gender=NEUTER|case=ACCUSATIVE	
ἀπωσαμένη	ἀπωθέω	VB	number=SINGULAR|mood=PARTICIPLE|gender=FEMININE|case=NOMINATIVE	
ἀλλ̓	ἀλλα	CONJ	_	
ἐμοὶ	ἐγώ	PRON	person=PERSON_1|number=SINGULAR|gender=FEMININE|case=DATIVE	
οὐ	οὐ	ADV	_	
δόρποιο	δόρπον	NN	number=SINGULAR|gender=MASCULINE|case=GENITIVE	
μελίφρονος	μελίφρων	ADJ	number=SINGULAR|gender=MASCULINE|case=GENITIVE	
ἤρατο	ἔραμαι	VB	person=PERSON_3|number=SINGULAR|tense=IMP|mood=INDICATIVE	
θυμός	θυμός	NN	number=SINGULAR|gender=MASCULINE|case=NOMINATIVE	
αὐτὰρ	αὐτὰρ	CONJ	_	
ἐπεὶ	ἐπεί	CONJ	_	
τέλεσαν	τελέω	VB	person=PERSON_3|number=PLURAL|mood=INDICATIVE|voice=ACTIVE	
καὶ	καί	CONJ	_	
ἐρώησαν	ἐρωέω	VB	person=PERSON_3|number=PLURAL|mood=INDICATIVE|voice=ACTIVE	
καμάτοιο	κάματος	NN	number=SINGULAR|gender=MASCULINE|case=GENITIVE	
βάν	βαίνω	VB	person=PERSON_3|number=PLURAL|mood=INDICATIVE|voice=ACTIVE	
ῥ̓	ἄρα	ADV	_	
ἴμεν	εἶμι	VB	tense=PR|mood=INFINITIVE|voice=ACTIVE	
οἴκαδ̓	οἴκαδε	ADV	_	
ἕκαστος	ἕκαστος	ADJ	number=SINGULAR|gender=MASCULINE|case=NOMINATIVE	
ὣς	ὣς	CONJ	_	
τότε	τότε	ADV	_	
μὲν	μέν	ADV	_	
πρόπαν	πρόπας	ADJ	number=SINGULAR|gender=NEUTER|case=ACCUSATIVE	
ἦμαρ	ἦμαρ	NN	number=SINGULAR|gender=NEUTER|case=ACCUSATIVE	
ὁμόφρονα	ὁμόφρων	ADJ	number=SINGULAR|gender=MASCULINE|case=ACCUSATIVE	
θυμὸν	θυμός	NN	number=SINGULAR|gender=MASCULINE|case=ACCUSATIVE	
ἔχουσαι	ἔχω	VB	number=PLURAL|tense=PR|mood=PARTICIPLE|voice=ACTIVE|gender=FEMININE|case=NOMINATIVE	
πολλὰ	πολλὰ	ADV	_	
μάλ̓	μάλα	ADV	_	
ἀλλήλων	ἀλλήλων	PRON	number=PLURAL|gender=MASCULINE|case=GENITIVE	
κραδίην	κραδίας	NN	number=SINGULAR|gender=MASCULINE|case=ACCUSATIVE	
καὶ	καί	CONJ	_	
θυμὸν	θυμός	NN	number=SINGULAR|gender=MASCULINE|case=ACCUSATIVE	
ἴαινον	ἰαίνω	VB	person=PERSON_3|number=PLURAL|tense=IMP|mood=INDICATIVE|voice=ACTIVE	
ἀμφαγαπαζόμεναι	ἀμφαγαπάζω	VB	number=PLURAL|tense=PR|mood=PARTICIPLE|gender=FEMININE|case=NOMINATIVE	
ἣ	ὁ	PRON	number=SINGULAR|gender=FEMININE|case=NOMINATIVE	
δ̓	δε	CONJ	_	
ἄρα	ἄρα	ADV	_	
θαμβήσασ̓	θαμβέω	VB	number=SINGULAR|mood=PARTICIPLE|voice=ACTIVE|gender=FEMININE|case=NOMINATIVE	
ὠρέξατο	ὀρέγω	VB	person=PERSON_3|number=SINGULAR|mood=INDICATIVE	
χερσὶν	χείρ	NN	number=PLURAL|gender=FEMININE|case=DATIVE	
ἅμ̓	ἅμα	ADV	_	
ἄμφω	ἄμφω	ADV	_	
καλὸν	καλός	ADJ	number=SINGULAR|gender=NEUTER|case=ACCUSATIVE	
ἄθυρμα	ἄθυρμα	NN	number=SINGULAR|gender=NEUTER|case=ACCUSATIVE	
λαβεῖν	λαμβάνω	VB	mood=INFINITIVE|voice=ACTIVE	
ἔνθα	ἔνθα	ADV	_	
γυναῖκες	γυνή	NN	number=PLURAL|gender=FEMININE|case=NOMINATIVE	
ἀνὰ	ἀνά	PREP	_	
μέγαρα	μέγαρον	NN	number=PLURAL|gender=NEUTER|case=ACCUSATIVE	
σκιόεντα	σκιόεις	ADJ	number=PLURAL|gender=NEUTER|case=ACCUSATIVE	
τηλίκαι	τηλίκος	ADJ	number=PLURAL|gender=FEMININE|case=NOMINATIVE	
ὡς	ὡς	CONJ	_	
σύ	σύ	PRON	person=PERSON_2|number=SINGULAR|case=NOMINATIVE	
περ	πέρ	ADV	_	
ὧδε	ὧδε	ADV	_	
καὶ	καί	CONJ	_	
ὁπλότεραι	ὁπλότερος	ADJ	number=PLURAL|gender=FEMININE|case=NOMINATIVE	
γεγάασιν	γίγνομαι	VB	person=PERSON_3|number=PLURAL|tense=PERF|mood=INDICATIVE|voice=ACTIVE	
αἵ	ὅς	PRON	number=PLURAL|gender=FEMININE|case=NOMINATIVE	
κέ	ἄν	ADV	_	
σε	σύ	PRON	person=PERSON_2|number=SINGULAR|case=ACCUSATIVE	
φίλωνται	φιλέω	VB	person=PERSON_3|number=PLURAL|mood=SUBJUNCTIVE	
ἠμὲν	ἠμέν	CONJ	_	
ἔπει	ἔπος	NN	number=SINGULAR|gender=NEUTER|case=DATIVE	
ἠδὲ	ἠδέ	CONJ	_	
καὶ	καὶ	ADV	_	
ἔργῳ	ἔργον	NN	number=SINGULAR|gender=NEUTER|case=DATIVE	
εἰσὶν	εἰμί	VB	person=PERSON_3|number=PLURAL|tense=PR|mood=INDICATIVE|voice=ACTIVE	
νῦν	νῦν	ADV	_	
αὖτε	αὖτε	ADV	_	
Κρήτηθεν	Κρήτηθεν	ADV	_	
ἐπ̓	ἐπι	PREP	_	
εὐρέα	εὐρύς	ADJ	number=PLURAL|gender=NEUTER|case=ACCUSATIVE	
νῶτα	νῶτον	NN	number=PLURAL|gender=NEUTER|case=ACCUSATIVE	
θαλάσσης	θάλασσα	NN	number=SINGULAR|gender=FEMININE|case=GENITIVE	
ἤλυθον	ἔρχομαι	VB	person=PERSON_1|number=SINGULAR|mood=INDICATIVE|voice=ACTIVE	
οὐκ	οὐ	ADV	_	
ἐθέλουσα	ἐθέλω	VB	number=SINGULAR|tense=PR|mood=PARTICIPLE|voice=ACTIVE|gender=FEMININE|case=NOMINATIVE	
βίῃ	βία	NN	number=SINGULAR|gender=FEMININE|case=DATIVE	
δ̓	δε	CONJ	_	
ἀέκουσαν	ἀέκων	ADJ	number=SINGULAR|gender=FEMININE|case=ACCUSATIVE	
ἀνάγκῃ	ἀνάγκη	NN	number=SINGULAR|gender=FEMININE|case=DATIVE	
ἄνδρες	ἀνήρ	NN	number=PLURAL|gender=MASCULINE|case=NOMINATIVE	
ληιστῆρες	λῃστήρ	NN	number=PLURAL|gender=MASCULINE|case=NOMINATIVE	
ἀπήγαγον	ἀπάγω	VB	person=PERSON_3|number=PLURAL|mood=INDICATIVE|voice=ACTIVE	
οὔ	οὐ	ADV	_	
τοι	τοι	ADV	_	
ἐν	ἐν	PREP	_	
ἀθανάτοισιν	ἀθάνατος	ADJ	number=PLURAL|gender=MASCULINE|case=DATIVE	
ἀεικὴς	ἀεικής	ADJ	number=SINGULAR|gender=MASCULINE|case=NOMINATIVE	
ἔσσομ̓	ειμι	VB	person=PERSON_1|number=SINGULAR|tense=FUTURE|mood=INDICATIVE	
ἀκοίτης	ἀκοίτης	NN	number=SINGULAR|gender=MASCULINE|case=NOMINATIVE	
αὐτοκασίγνητος	αὐτοκασίγνητος	NN	number=SINGULAR|gender=MASCULINE|case=NOMINATIVE	
πατρὸς	πατήρ	NN	number=SINGULAR|gender=MASCULINE|case=GENITIVE	
Διός	Ζεύς	NN	number=SINGULAR|gender=MASCULINE|case=GENITIVE	
ἐγὼ	ἐγώ	PRON	person=PERSON_1|number=SINGULAR|gender=MASCULINE|case=NOMINATIVE	
τῇ	ὁ	PRON	number=SINGULAR|gender=FEMININE|case=DATIVE	
δὲ	δὲ	CONJ	_	
χολωσαμένη	χολόω	VB	number=SINGULAR|mood=PARTICIPLE|gender=FEMININE|case=NOMINATIVE	
καλλιστέφανος	καλλιστέφανος	ADJ	number=SINGULAR|gender=FEMININE|case=NOMINATIVE	
Δημήτηρ	Δημήτηρ	NN	number=SINGULAR|gender=FEMININE|case=NOMINATIVE	
παῖδα	παῖς	NN	number=SINGULAR|gender=MASCULINE|case=ACCUSATIVE	
φίλον	φίλος	ADJ	number=SINGULAR|gender=MASCULINE|case=ACCUSATIVE	
τὸν	ὁ		number=SINGULAR|gender=MASCULINE|case=ACCUSATIVE	
ἄελπτον	ἄελπτος	ADJ	number=SINGULAR|gender=MASCULINE|case=ACCUSATIVE	
ἐνὶ	ἐν	PREP	_	
μεγάροισιν	μέγαρον	NN	number=PLURAL|gender=NEUTER|case=DATIVE	
ἔτικτε	τίκτω	VB	person=PERSON_3|number=SINGULAR|tense=IMP|mood=INDICATIVE|voice=ACTIVE	
χείρεσσ̓	χείρ	NN	number=PLURAL|gender=FEMININE|case=DATIVE	
ἀθανάτῃσιν	ἀθάνατος	ADJ	number=PLURAL|gender=FEMININE|case=DATIVE	
ἀπὸ	ἀπό	PREP	_	
ἕθεν	ἕ	PRON	number=SINGULAR|gender=FEMININE|case=GENITIVE	
ἧκε	ἵημι	VB	person=PERSON_3|number=SINGULAR|mood=INDICATIVE|voice=ACTIVE	
πέδονδε	πέδονδε	ADV	_	
ἐξανελοῦσα	ἐξαναιρέω	VB	number=SINGULAR|mood=PARTICIPLE|voice=ACTIVE|gender=FEMININE|case=NOMINATIVE	
πυρός	πῦρ	NN	number=SINGULAR|gender=NEUTER|case=GENITIVE	
θυμῷ	θυμός	NN	number=SINGULAR|gender=MASCULINE|case=DATIVE	
κοτέσασα	κοτέω	VB	number=SINGULAR|mood=PARTICIPLE|voice=ACTIVE|gender=FEMININE|case=NOMINATIVE	
μάλ̓	μάλα	ADV	_	
αἰνῶς	αἰνῶς	ADV	_	
καί	καί	CONJ	_	
ῥ̓	ἄρα	ADV	_	
ἄμυδις	ἄμυδις	ADV	_	
προσέειπεν	προσεῖπον	VB	person=PERSON_3|number=SINGULAR|mood=INDICATIVE|voice=ACTIVE	
ἐύζωνον	εὔζωνος	ADJ	number=SINGULAR|gender=FEMININE|case=ACCUSATIVE	
Μετάνειραν	Μετανείρα	NN	number=SINGULAR|gender=FEMININE|case=ACCUSATIVE	
ὣς	ὡς	CONJ	_	
ἔφαθ̓	φῆμι	VB	person=PERSON_3|number=SINGULAR|tense=IMP|mood=INDICATIVE	
ἔκευθε	κεύθω	VB	person=PERSON_3|number=SINGULAR|tense=IMP|mood=INDICATIVE|voice=ACTIVE	
δ̓	δε	CONJ	_	
ἄρα	ἄρα	ADV	_	
κρῖ	κρῖ	NN	number=SINGULAR|gender=NEUTER|case=NOMINATIVE	
λευκὸν	λευκός	ADJ	number=SINGULAR|gender=NEUTER|case=NOMINATIVE	
μήδεσι	μῆδος	NN	number=PLURAL|gender=NEUTER|case=DATIVE	
Δήμητρος	Δημήτηρ	NN	number=SINGULAR|gender=FEMININE|case=GENITIVE	
καλλισφύρου	καλλίσφυρος	NN	number=SINGULAR|gender=FEMININE|case=GENITIVE	
χάνε	χάσκω	VB	person=PERSON_3|number=SINGULAR|mood=INDICATIVE|voice=ACTIVE	
δὲ	δὲ	CONJ	_	
χθὼν	χθών	NN	number=SINGULAR|gender=FEMININE|case=NOMINATIVE	
εὐρυάγυια	εὐρυάγυια	ADJ	number=SINGULAR|gender=FEMININE|case=NOMINATIVE	
Νύσιον	Νύσιος	ADJ	number=SINGULAR|gender=NEUTER|case=ACCUSATIVE	
ἂμ	ἀνά	PREP	_	
πεδίον	πεδίον	NN	number=SINGULAR|gender=NEUTER|case=ACCUSATIVE	
τῇ	ὁ	PRON	number=SINGULAR|gender=FEMININE|case=DATIVE	
ὄρουσεν	ὀρούω	VB	person=PERSON_3|number=SINGULAR|mood=INDICATIVE|voice=ACTIVE	
ἄναξ	ἄναξ	NN	number=SINGULAR|gender=MASCULINE|case=NOMINATIVE	
Πολυδέγμων	πολυδέγμων	ADJ	number=SINGULAR|gender=MASCULINE|case=NOMINATIVE	
ἵπποις	ἵππος	NN	number=PLURAL|gender=MASCULINE|case=DATIVE	
ἀθανάτοισι	ἀθάνατος	ADJ	number=PLURAL|gender=MASCULINE|case=DATIVE	
Κρόνου	Κρόνος	NN	number=SINGULAR|gender=MASCULINE|case=GENITIVE	
πολυώνυμος	πολυώνυμος	ADJ	number=SINGULAR|gender=MASCULINE|case=NOMINATIVE	
υἱός	υἱός	NN	number=SINGULAR|gender=MASCULINE|case=NOMINATIVE	
τέκνον	τέκνον	NN	number=SINGULAR|gender=NEUTER|case=VOCATIVE	
Δημοφόων	Δημοφόων	NN	number=SINGULAR|gender=MASCULINE|case=VOCATIVE	
ξείνη	ξένος	ADJ	number=SINGULAR|gender=FEMININE|case=NOMINATIVE	
σε	σύ	PRON	person=PERSON_2|number=SINGULAR|case=ACCUSATIVE	
πυρὶ	πῦρ	NN	number=SINGULAR|gender=NEUTER|case=DATIVE	
ἔνι	ἐν	PREP	_	
πολλῷ	πολύς	ADJ	number=SINGULAR|gender=NEUTER|case=DATIVE	
κρύπτει	κρύπτω	VB	person=PERSON_3|number=SINGULAR|tense=PR|mood=INDICATIVE|voice=ACTIVE	
ἐμοὶ	ἐγώ	PRON	person=PERSON_1|number=SINGULAR|gender=FEMININE|case=DATIVE	
δὲ	δὲ	CONJ	_	
γόον	γόος	NN	number=SINGULAR|gender=MASCULINE|case=ACCUSATIVE	
καὶ	καί	CONJ	_	
κήδεα	κῆδος	NN	number=PLURAL|gender=NEUTER|case=ACCUSATIVE	
λυγρὰ	λυγρός	ADJ	number=PLURAL|gender=NEUTER|case=ACCUSATIVE	
τίθησιν	τίθημι	VB	person=PERSON_3|number=SINGULAR|tense=PR|mood=INDICATIVE|voice=ACTIVE	
αὐτὰρ	αὐτὰρ	CONJ	_	
ἐγὼ	ἐγώ	PRON	person=PERSON_1|number=SINGULAR|gender=FEMININE|case=NOMINATIVE	
δρεπόμην	δρέπω	VB	person=PERSON_1|number=SINGULAR|tense=IMP|mood=INDICATIVE	
περὶ	περί	PREP	_	
χάρματι	χάρμα	NN	number=SINGULAR|gender=NEUTER|case=DATIVE	
ἀμφὶ	ἀμφί	PREP	_	
δὲ	δὲ	CONJ	_	
χαῖται	χαίτη	NN	number=PLURAL|gender=FEMININE|case=NOMINATIVE	
ὤμοις	ὦμος	NN	number=PLURAL|gender=MASCULINE|case=DATIVE	
ἀίσσοντο	ἀίσσω	VB	person=PERSON_3|number=PLURAL|tense=IMP|mood=INDICATIVE	
κροκηίῳ	κροκήιος	ADJ	number=SINGULAR|gender=NEUTER|case=DATIVE	
ἄνθει	ἄνθος	NN	number=SINGULAR|gender=NEUTER|case=DATIVE	
ὁμοῖαι	ὅμοιος	ADJ	number=PLURAL|gender=FEMININE|case=NOMINATIVE	
ταῦτά	οὗτος	PRON	number=PLURAL|gender=NEUTER|case=ACCUSATIVE	
τοι	τοι	ADV	_	
ἀχνυμένη	ἀχεύω	VB	number=SINGULAR|tense=PR|mood=PARTICIPLE|voice=PASSIVE|gender=FEMININE|case=NOMINATIVE	
περ	πέρ	ADV	_	
ἀληθέα	ἀληθής	ADJ	number=PLURAL|gender=NEUTER|case=ACCUSATIVE	
πάντ̓	πᾶς	ADJ	number=PLURAL|gender=NEUTER|case=ACCUSATIVE	
ἀγορεύω	ἀγορεύω	VB	person=PERSON_1|number=SINGULAR|tense=PR|mood=INDICATIVE|voice=ACTIVE	
αὐτὰρ	αὐτὰρ	CONJ	_	
ἐπειδὴ	ἐπεί	CONJ	_	
πάνθ̓	πάς	ADJ	number=PLURAL|gender=MASCULINE|case=ACCUSATIVE	
ὑπεθήκατο	ὑποτίθημι	VB	person=PERSON_3|number=SINGULAR|mood=INDICATIVE	
δῖα	δῖος	ADJ	number=SINGULAR|gender=FEMININE|case=NOMINATIVE	
θεάων	θέα	NN	number=PLURAL|gender=FEMININE|case=GENITIVE	
βάν	βαίνω	VB	person=PERSON_3|number=PLURAL|mood=INDICATIVE|voice=ACTIVE	
ῥ̓	ἄρα	ADV	_	
ἴμεν	εἶμι	VB	tense=PR|mood=INFINITIVE|voice=ACTIVE	
Οὔλυμπόνδε	Ὄλυμπόνδε	ADV	_	
θεῶν	θεὸς	NN	number=PLURAL|gender=MASCULINE|case=GENITIVE	
μεθ̓	μετα	PREP	_	
ὁμήγυριν	ὁμήγυρις	NN	number=SINGULAR|gender=FEMININE|case=ACCUSATIVE	
ἄλλων	ἄλλος	PRON	number=PLURAL|gender=MASCULINE|case=GENITIVE	
ἀμοιβηδὶς	ἀμοιβηδίς	ADV	_	
δὲ	δὲ	CONJ	_	
κιόντες	κίω	VB	number=PLURAL|mood=PARTICIPLE|voice=ACTIVE|gender=MASCULINE|case=NOMINATIVE	
κίκλησκον	κικλήσκω	VB	person=PERSON_3|number=PLURAL|tense=IMP|mood=INDICATIVE|voice=ACTIVE	
καὶ	καί	CONJ	_	
πολλὰ	πολύς	ADJ	number=PLURAL|gender=NEUTER|case=ACCUSATIVE	
δίδον	δίδωμι	VB	person=PERSON_3|number=PLURAL|tense=IMP|mood=INDICATIVE|voice=ACTIVE	
περικαλλέα	περικαλλής	ADJ	number=PLURAL|gender=NEUTER|case=ACCUSATIVE	
δῶρα	δῶρον	NN	number=PLURAL|gender=NEUTER|case=ACCUSATIVE	
τιμάς	τιμή	NN	number=PLURAL|gender=FEMININE|case=ACCUSATIVE	
θ̓	τε	CONJ	_	
ἅς	ἅς	CONJ	_	
κ̓	ὰν	ADV	_	
ἐθέλοιτο	ἐθέλω	VB	person=PERSON_3|number=SINGULAR|tense=PR	
μετ̓	μετα	PREP	_	
ἀθανάτοισιν	ἀθάνατος	ADJ	number=PLURAL|gender=MASCULINE|case=DATIVE	
ἑλέσθαι	αἱρέω	VB	mood=INFINITIVE	
εἰμὶ	εἰμί	VB	person=PERSON_1|number=SINGULAR|tense=PR|mood=INDICATIVE|voice=ACTIVE	
δὲ	δὲ	CONJ	_	
Δημήτηρ	Δημήτηρ	NN	number=SINGULAR|gender=FEMININE|case=NOMINATIVE	
τιμάοχος	τιμάοχος	ADJ	number=SINGULAR|gender=FEMININE|case=NOMINATIVE	
ἥτε	ὅστε	PRON	number=SINGULAR|gender=FEMININE|case=NOMINATIVE	
μέγιστον	μέγας	ADJ	number=SINGULAR|gender=NEUTER|case=ACCUSATIVE	
ἀθανάτοις	ἀθάνατος	ADJ	number=PLURAL|gender=MASCULINE|case=DATIVE	
θνητοῖς	θνητός	ADJ	number=PLURAL|gender=MASCULINE|case=DATIVE	
τ̓	τε	CONJ	_	
ὄνεαρ	ὄνειαρ	NN	number=SINGULAR|gender=NEUTER|case=ACCUSATIVE	
καὶ	καί	CONJ	_	
χάρμα	χάρμα	NN	number=SINGULAR|gender=NEUTER|case=ACCUSATIVE	
τέτυκται	τεύχω	VB	person=PERSON_3|number=SINGULAR|tense=PERF|mood=INDICATIVE	
αἶψα	αἶψα	ADV	_	
δὲ	δὲ	CONJ	_	
δώμαθ̓	δῶμα	NN	number=PLURAL|gender=NEUTER|case=ACCUSATIVE	
ἵκοντο	ἱκνέομαι	VB	person=PERSON_3|number=PLURAL|mood=INDICATIVE	
διοτρεφέος	Διοτρεφής	ADJ	number=SINGULAR|gender=MASCULINE|case=GENITIVE	
Κελεοῖο	Κελεός	NN	number=SINGULAR|gender=MASCULINE|case=GENITIVE	
βὰν	βαίνω	VB	person=PERSON_3|number=PLURAL|mood=INDICATIVE|voice=ACTIVE	
δὲ	δὲ	CONJ	_	
δἰ	διὰ	PREP	_	
αἰθούσης	αἴθουσα	NN	number=SINGULAR|gender=FEMININE|case=GENITIVE	
ἔνθα	ἔνθα	CONJ	_	
σφίσι	σφεῖς	PRON	number=PLURAL|gender=FEMININE|case=DATIVE	
πότνια	πότνια	NN	number=SINGULAR|gender=FEMININE|case=NOMINATIVE	
μήτηρ	μήτηρ	NN	number=SINGULAR|gender=FEMININE|case=NOMINATIVE	
ἧστο	ἧμαι	VB	person=PERSON_3|number=SINGULAR|tense=PLUSQUAMPERFECT|mood=INDICATIVE	
παρὰ	παρά	PREP	_	
σταθμὸν	σταθμός	NN	number=SINGULAR|gender=MASCULINE|case=ACCUSATIVE	
τέγεος	τέγος	NN	number=SINGULAR|gender=NEUTER|case=GENITIVE	
πύκα	πύκα	ADV	_	
ποιητοῖο	ποιητός	ADJ	number=SINGULAR|gender=NEUTER|case=GENITIVE	
παῖδ̓	παῖς	NN	number=SINGULAR|gender=MASCULINE|case=ACCUSATIVE	
ὑπὸ	ὑπό	PREP	_	
κόλπῳ	κόλπος	NN	number=SINGULAR|gender=MASCULINE|case=DATIVE	
ἔχουσα	ἔχω	VB	number=SINGULAR|tense=PR|mood=PARTICIPLE|voice=ACTIVE|gender=FEMININE|case=NOMINATIVE	
νέον	νέος	ADJ	number=SINGULAR|gender=NEUTER|case=NOMINATIVE	
θάλος	θάλος	NN	number=SINGULAR|gender=NEUTER|case=ACCUSATIVE	
ὣς	ὡς	CONJ	_	
ἣ	ὁ	PRON	number=SINGULAR|gender=FEMININE|case=NOMINATIVE	
μὲν	μέν	ADV	_	
Κελεοῖο	Κελεός	NN	number=SINGULAR|gender=MASCULINE|case=GENITIVE	
δαΐφρονος	δαίφρων	ADJ	number=SINGULAR|case=GENITIVE	
ἀγλαὸν	ἀγλαός	ADJ	number=SINGULAR|gender=MASCULINE|case=ACCUSATIVE	
υἱὸν	υἱός	NN	number=SINGULAR|gender=MASCULINE|case=ACCUSATIVE	
Δημοφόωνθ̓	Δήμοφων	NN	number=SINGULAR|gender=MASCULINE|case=ACCUSATIVE	
ὃν	ὅς	PRON	number=SINGULAR|gender=MASCULINE|case=ACCUSATIVE	
ἔτικτεν	τίκτω	VB	person=PERSON_3|number=SINGULAR|tense=IMP|mood=INDICATIVE|voice=ACTIVE	
ἐύζωνος	εὔζωνος	ADJ	number=SINGULAR|gender=FEMININE|case=NOMINATIVE	
Μετάνειρα	Μετανείρα	NN	number=SINGULAR|gender=FEMININE|case=NOMINATIVE	
ἔτρεφεν	τρέφω	VB	person=PERSON_3|number=SINGULAR|tense=IMP|mood=INDICATIVE|voice=ACTIVE	
ἐν	ἐν	PREP	_	
μεγάροις	μέγαρον	NN	number=PLURAL|gender=NEUTER|case=DATIVE	
ἀλλά	ἀλλά	CONJ	_	
θεά	θέα	NN	number=SINGULAR|gender=FEMININE|case=VOCATIVE	
κατάπαυε	καταπαύω	VB	person=PERSON_2|number=SINGULAR|tense=PR|mood=IMPERATIVE|voice=ACTIVE	
μέγαν	μέγας	ADJ	number=SINGULAR|gender=MASCULINE|case=ACCUSATIVE	
γόον	γόος	NN	number=SINGULAR|gender=MASCULINE|case=ACCUSATIVE	
τῆς	ὁ	PRON	number=SINGULAR|gender=FEMININE|case=GENITIVE	
δ̓	δε	CONJ	_	
αὐτίκα	αὐτίκα	ADV	_	
γούνατ̓	γόνυ	NN	number=PLURAL|gender=NEUTER|case=NOMINATIVE	
ἔλυντο	λύω	VB	person=PERSON_3|number=PLURAL|mood=INDICATIVE|voice=PASSIVE	
δηρὸν	δηρός	ADJ	number=SINGULAR|gender=MASCULINE|case=ACCUSATIVE	
δ̓	δε	CONJ	_	
ἄφθογγος	ἄφθογγος	ADJ	number=SINGULAR|gender=FEMININE|case=NOMINATIVE	
γένετο	γίγνομαι	VB	person=PERSON_3|number=SINGULAR|mood=INDICATIVE	
χρόνον	χρόνος	NN	number=SINGULAR|gender=MASCULINE|case=ACCUSATIVE	
οὐδέ	οὐδέ	CONJ	_	
τι	τις	PRON	number=SINGULAR|gender=NEUTER|case=NOMINATIVE	
παιδὸς	παῖς	NN	number=SINGULAR|gender=MASCULINE|case=GENITIVE	
μνήσατο	μιμνήσκω	VB	person=PERSON_3|number=SINGULAR|mood=INDICATIVE	
τηλυγέτοιο	τηλύγετος	ADJ	number=SINGULAR|gender=MASCULINE|case=GENITIVE	
ἀπὸ	ἀπό	PREP	_	
δαπέδου	δάπεδον	NN	number=SINGULAR|gender=NEUTER|case=GENITIVE	
ἀνελέσθαι	ἀναιρέω	VB	mood=INFINITIVE	
μαῖα	μαῖα	NN	number=SINGULAR|gender=FEMININE|case=VOCATIVE	
θεῶν	θεὸς	NN	number=PLURAL|gender=MASCULINE|case=GENITIVE	
μὲν	μέν	ADV	_	
δῶρα	δῶρον	NN	number=PLURAL|gender=NEUTER|case=ACCUSATIVE	
καὶ	καὶ	ADV	_	
ἀχνύμενοί	ἀχεύω	VB	number=PLURAL|tense=PR|mood=PARTICIPLE|voice=PASSIVE|gender=MASCULINE|case=NOMINATIVE	
περ	πέρ	ADV	_	
ἀνάγκῃ	ἀνάγκη	NN	number=SINGULAR|gender=FEMININE|case=DATIVE	
τέτλαμεν	τλάω	VB	person=PERSON_1|number=PLURAL|tense=PERF|mood=INDICATIVE|voice=ACTIVE	
ἄνθρωποι	ἄνθρωπος	NN	number=PLURAL|gender=MASCULINE|case=NOMINATIVE	
τῇ	ὁ	PRON	number=SINGULAR|gender=FEMININE|case=DATIVE	
δ̓	δε	CONJ	_	
οὐκ	οὐ	ADV	_	
ἐπεπείθετο	ἐπιπείθομαι	VB	person=PERSON_3|number=SINGULAR|tense=IMP|mood=INDICATIVE	
θυμός	θυμός	NN	number=SINGULAR|gender=MASCULINE|case=NOMINATIVE	
ἀγχοῦ	ἀγχοῦ	ADV	_	
δ̓	δε	CONJ	_	
ἱστάμεναι	ἵστημι	VB	number=PLURAL|tense=PR|mood=PARTICIPLE|gender=FEMININE|case=NOMINATIVE	
ἔπεα	ἔπος	NN	number=PLURAL|gender=NEUTER|case=ACCUSATIVE	
πτερόεντα	πτερόεις	ADJ	number=PLURAL|gender=NEUTER|case=ACCUSATIVE	
προσηύδων	προσαυδάω	VB	person=PERSON_3|number=PLURAL|tense=IMP|mood=INDICATIVE|voice=ACTIVE	
ἣ	ὁ		number=SINGULAR|gender=FEMININE|case=NOMINATIVE	
δ̓	δε	CONJ	_	
ἐπέεσσιν	ἔπος	NN	number=PLURAL|gender=NEUTER|case=DATIVE	
ἀμείβετο	ἀμείβω	VB	person=PERSON_3|number=SINGULAR|tense=IMP|mood=INDICATIVE	
πότνα	πότνα	NN	number=SINGULAR|gender=FEMININE|case=NOMINATIVE	
θεάων	θέα	NN	number=PLURAL|gender=FEMININE|case=GENITIVE	
οὐδ̓	οὐδε	ADV	_	
ἔγνον	γιγνώσκω	VB	person=PERSON_3|number=PLURAL|mood=INDICATIVE|voice=ACTIVE	
ἀγχοῦ	ἀγχοῦ	ADV	_	
δ̓	δε	CONJ	_	
ἱστάμενος	ἵστημι	VB	number=SINGULAR|tense=PR|mood=PARTICIPLE|gender=MASCULINE|case=NOMINATIVE	
προσέφη	πρόσφημι	VB	person=PERSON_3|number=SINGULAR|tense=IMP|mood=INDICATIVE|voice=ACTIVE	
κρατὺς	κρατύς	ADJ	number=SINGULAR|gender=MASCULINE|case=NOMINATIVE	
Ἀργειφόντης	Ἀργειφόντης	NN	number=SINGULAR|gender=MASCULINE|case=NOMINATIVE	
ἣ	ὁ	PRON	number=SINGULAR|gender=FEMININE|case=NOMINATIVE	
δ̓	δε	CONJ	_	
ἔσσυτο	σεύω	VB	person=PERSON_3|number=SINGULAR|tense=IMP|mood=INDICATIVE	
πόσσ̓	πούς	NN	number=PLURAL|gender=NEUTER|case=DATIVE	
ἁπαλοῖσι	ἁπαλός	ADJ	number=PLURAL|gender=NEUTER|case=DATIVE	
μητέῤ	μήτηρ	NN	number=SINGULAR|gender=FEMININE|case=NOMINATIVE	
ἀναστήσουσα	ἀνίστημι	VB	number=SINGULAR|tense=FUTURE|mood=PARTICIPLE|voice=ACTIVE|gender=FEMININE|case=NOMINATIVE	
θυώδεος	θυώδης	ADJ	number=SINGULAR|gender=MASCULINE|case=GENITIVE	
ἐκ	ἐκ	PREP	_	
θαλάμοιο	θάλαμος	NN	number=SINGULAR|gender=MASCULINE|case=GENITIVE	
πολλὰ	πολύς	ADJ	number=PLURAL|gender=NEUTER|case=ACCUSATIVE	
δὲ	δὲ	CONJ	_	
καμπύλ̓	καμπύλος	ADJ	number=PLURAL|gender=NEUTER|case=ACCUSATIVE	
ἄροτρα	ἄροτρον	NN	number=PLURAL|gender=NEUTER|case=ACCUSATIVE	
μάτην	μάτην	ADV	_	
βόες	βοῦς	NN	number=PLURAL|gender=MASCULINE|case=NOMINATIVE	
εἷλκον	ἕλκω	VB	person=PERSON_3|number=PLURAL|tense=IMP|mood=INDICATIVE|voice=ACTIVE	
ἀρούραις	ἄρουρα	NN	number=PLURAL|gender=FEMININE|case=DATIVE	
ἣ	ὁ	PRON	number=SINGULAR|gender=FEMININE|case=NOMINATIVE	
δὲ	δὲ	CONJ	_	
κιοῦσα	κίω	VB	number=SINGULAR|mood=PARTICIPLE|voice=ACTIVE|gender=FEMININE|case=NOMINATIVE	
θεμιστοπόλοις	θεμιστοπόλος	ADJ	number=PLURAL|gender=MASCULINE|case=DATIVE	
βασιλεῦσι	βασιλεύς	NN	number=PLURAL|gender=MASCULINE|case=DATIVE	
δεῖξεν	δείκνυμι	VB	person=PERSON_3|number=SINGULAR|mood=INDICATIVE|voice=ACTIVE	
Τριπτολέμῳ	Τριπτόλεμος	NN	number=SINGULAR|gender=MASCULINE|case=DATIVE	
τε	τε	CONJ	_	
Διοκλεῖ	Διοκλέης	NN	number=SINGULAR|gender=MASCULINE|case=DATIVE	
τε	τε	CONJ	_	
πληξίππῳ	πλήξιππος	ADJ	number=SINGULAR|gender=MASCULINE|case=DATIVE	
Εὐμόλπου	Εὔμολπος	NN	number=SINGULAR|gender=MASCULINE|case=GENITIVE	
τε	τε	CONJ	_	
βίῃ	βία	NN	number=SINGULAR|gender=FEMININE|case=DATIVE	
Κελεῷ	Κελεός	NN	number=SINGULAR|gender=MASCULINE|case=DATIVE	
θ̓	τε	CONJ	_	
ἡγήτορι	ἡγήτωρ	NN	number=SINGULAR|gender=MASCULINE|case=DATIVE	
λαῶν	λαός	NN	number=PLURAL|gender=MASCULINE|case=GENITIVE	
δρησμοσύνην	δρησμοσύνη	NN	number=SINGULAR|gender=FEMININE|case=ACCUSATIVE	
θ̓	τε	CONJ	_	
ἱερῶν	ἱερά	NN	number=PLURAL|gender=FEMININE|case=GENITIVE	
καὶ	καί	CONJ	_	
ἐπέφραδεν	φράζω	VB	person=PERSON_3|number=SINGULAR|mood=INDICATIVE|voice=ACTIVE	
ὄργια	ὄργια	NN	number=PLURAL|gender=NEUTER|case=ACCUSATIVE	
πᾶσι	πᾶς	ADJ	number=PLURAL|gender=MASCULINE|case=DATIVE	
Τριπτολέμῳ	Τριπτόλεμος	NN	number=SINGULAR|gender=MASCULINE|case=DATIVE	
τε	τε	CONJ	_	
Πολυξείνῳ	Πολύξεινος	NN	number=SINGULAR|gender=MASCULINE|case=DATIVE	
ἐπὶ	ἐπί	PREP	_	
τοῖς	ὁ	PRON	number=PLURAL|gender=MASCULINE|case=DATIVE	
δὲ	δὲ	CONJ	_	
Διοκλεῖ	Διοκλέης	NN	number=SINGULAR|gender=MASCULINE|case=DATIVE	
σεμνά	σεμνόν	NN	number=PLURAL|gender=NEUTER|case=ACCUSATIVE	
τά	ὁ	PRON	number=PLURAL|gender=NEUTER|case=NOMINATIVE	
τ̓	τε	CONJ	_	
οὔπως	οὔπως	ADV	_	
ἔστι	εἰμί	VB	person=PERSON_3|number=SINGULAR|tense=PR|mood=INDICATIVE|voice=ACTIVE	
παρεξίμεν	παρέξειμι	VB	tense=PR|mood=INFINITIVE|voice=ACTIVE	
οὔτε	οὐτε	CONJ	_	
πυθέσθαι	πυνθάνομαι	VB	mood=INFINITIVE	
οὔτ̓	οὔτε	CONJ	_	
ἀχέειν	ἠχέω	VB	tense=PR|mood=INFINITIVE|voice=ACTIVE	
ἐπέφραδεν	φράζω	VB	person=PERSON_3|number=SINGULAR|mood=INDICATIVE|voice=ACTIVE	
τέκνον	τέκνον	NN	number=SINGULAR|gender=NEUTER|case=VOCATIVE	
μή	μή	ADV	_	
ῥά	ἄρα	ADV	_	
τι	τι	ADV	_	
μοι	ἐγώ	PRON	person=PERSON_1|number=SINGULAR|gender=FEMININE|case=DATIVE	
σ[ύ	σύ	PRON	person=PERSON_2|number=SINGULAR|case=NOMINATIVE	
γε	γε	ADV	_	
πάσσαο	πατέομαι	VB	person=PERSON_2|number=SINGULAR|mood=INDICATIVE	
νέρθεν	ἔνερθε	ADV	_	
ἐοῦσα	εἰμί	VB	number=SINGULAR|tense=PR|mood=PARTICIPLE|voice=ACTIVE|gender=FEMININE|case=NOMINATIVE	
βρώμης	βρώμη	NN	number=SINGULAR|gender=FEMININE|case=GENITIVE	
ὄφρα	ὄφρα	CONJ	_	
μὲν	μέν	ADV	_	
οὖν	οὖν	ADV	_	
γαῖάν	γαῖα	NN	number=SINGULAR|gender=FEMININE|case=ACCUSATIVE	
τε	τε	CONJ	_	
καὶ	καί	CONJ	_	
οὐρανὸν	οὐρανός	NN	number=SINGULAR|gender=MASCULINE|case=ACCUSATIVE	
ἀστερόεντα	ἀστερόεις	ADJ	number=SINGULAR|gender=MASCULINE|case=ACCUSATIVE	
λεῦσσε	λεύσσω	VB	person=PERSON_3|number=SINGULAR|tense=IMP|mood=INDICATIVE|voice=ACTIVE	
θεὰ	θεά	NN	number=SINGULAR|gender=FEMININE|case=NOMINATIVE	
καὶ	καί	CONJ	_	
πόντον	πόντος	NN	number=SINGULAR|gender=MASCULINE|case=ACCUSATIVE	
ἀγάρροον	ἀγάρροος	ADJ	number=SINGULAR|gender=MASCULINE|case=ACCUSATIVE	
ἰχθυόεντα	ἰχθυόεις	ADJ	number=SINGULAR|gender=MASCULINE|case=ACCUSATIVE	
αὐγάς	αὐγή	NN	number=PLURAL|gender=FEMININE|case=ACCUSATIVE	
τ̓	τε	CONJ	_	
ἠελίου	ἥλιος	NN	number=SINGULAR|gender=MASCULINE|case=GENITIVE	
ἔτι	ἔτι	ADV	_	
δ̓	δε	CONJ	_	
ἤλπετο	ἔλπω	VB	person=PERSON_3|number=SINGULAR|tense=IMP|mood=INDICATIVE	
μητέρα	μήτηρ	NN	number=SINGULAR|gender=FEMININE|case=ACCUSATIVE	
κεδνὴν	κεδνός	ADJ	number=SINGULAR|gender=FEMININE|case=ACCUSATIVE	
ὄψεσθαι	ὁράω	VB	tense=FUTURE|mood=INFINITIVE	
καὶ	καὶ	ADV	_	
φῦλα	φῦλον	NN	number=PLURAL|gender=NEUTER|case=ACCUSATIVE	
θεῶν	θεὸς	NN	number=PLURAL|gender=MASCULINE|case=GENITIVE	
αἰειγενετάων	αἰειγενετάος	ADJ	number=PLURAL|gender=MASCULINE|case=GENITIVE	
τόφρα	τόφρα	ADV	_	
οἱ	ἕ	PRON	number=SINGULAR|gender=FEMININE|case=DATIVE	
ἐλπὶς	ἐλπίς	NN	number=SINGULAR|gender=FEMININE|case=NOMINATIVE	
ἔθελγε	θέλγω	VB	person=PERSON_3|number=SINGULAR|tense=IMP|mood=INDICATIVE|voice=ACTIVE	
μέγαν	μέγας	ADJ	number=SINGULAR|gender=MASCULINE|case=ACCUSATIVE	
νόον	νόος	NN	number=SINGULAR|gender=MASCULINE|case=ACCUSATIVE	
ἀχνυμένης	ἀχεύω	VB	number=SINGULAR|tense=PR|mood=PARTICIPLE|voice=PASSIVE|gender=FEMININE|case=GENITIVE	
περ	πέρ	ADV	_	
τῇ	ὁ	PRON	number=SINGULAR|gender=FEMININE|case=DATIVE	
δ̓	δε	CONJ	_	
οὔτις	οὔτις	PRON	number=SINGULAR|gender=MASCULINE|case=NOMINATIVE	
ἐτήτυμα	ἐτήτυμος	ADJ	number=PLURAL|gender=NEUTER|case=ACCUSATIVE	
μυθήσασθαι	μυθέομαι	VB	mood=INFINITIVE	
ἤθελεν	ἐθέλω	VB	person=PERSON_3|number=SINGULAR|tense=IMP|mood=INDICATIVE|voice=ACTIVE	
οὔτε	οὐτε	CONJ	_	
θεῶν	θεὸς	NN	number=PLURAL|gender=MASCULINE|case=GENITIVE	
οὔτε	οὐτε	CONJ	_	
θνητῶν	θνητός	ADJ	number=PLURAL|gender=MASCULINE|case=GENITIVE	
ἀνθρώπων	ἄνθρωπος	NN	number=PLURAL|gender=MASCULINE|case=GENITIVE	
οὔτ̓	οὔτε	CONJ	_	
οἰωνῶν	οἰωνός	NN	number=PLURAL|gender=MASCULINE|case=GENITIVE	
τις	τις	PRON	number=SINGULAR|gender=MASCULINE|case=NOMINATIVE	
τῇ	ὁ	PRON	number=SINGULAR|gender=FEMININE|case=DATIVE	
ἐτήτυμος	ἐτήτυμος	ADJ	number=SINGULAR|gender=MASCULINE|case=NOMINATIVE	
ἄγγελος	ἄγγελος	NN	number=SINGULAR|gender=MASCULINE|case=NOMINATIVE	
ἦλθεν	ἔρχομαι	VB	person=PERSON_3|number=SINGULAR|mood=INDICATIVE|voice=ACTIVE	
οὐδὲ	οὐδὲ	CONJ	_	
θάλασσα	θάλασσα	NN	number=SINGULAR|gender=FEMININE|case=NOMINATIVE	
οὔθ̓	οὔτε	CONJ	_	
ὕδωρ	ὕδωρ	NN	number=SINGULAR|gender=NEUTER|case=NOMINATIVE	
ποταμῶν	ποταμός	NN	number=PLURAL|gender=MASCULINE|case=GENITIVE	
οὔτ̓	οὔτε	CONJ	_	
ἄγκεα	ἄγκος	NN	number=PLURAL|gender=NEUTER|case=NOMINATIVE	
ποιήεντα	ποιήεις	ADJ	number=PLURAL|gender=NEUTER|case=NOMINATIVE	
ἵππων	ἵππος	NN	number=PLURAL|gender=MASCULINE|case=GENITIVE	
ἀθανάτων	ἀθάνατος	ADJ	number=PLURAL|gender=MASCULINE|case=GENITIVE	
οὔτ̓	οὔτε	CONJ	_	
ἄκριες	ἄκρις	NN	number=PLURAL|gender=FEMININE|case=NOMINATIVE	
ἔσχεθον	εχω	VB	person=PERSON_3|number=PLURAL|mood=INDICATIVE|voice=ACTIVE	
ὁρμήν	ὁρμή	NN	number=SINGULAR|gender=FEMININE|case=ACCUSATIVE	
ἀλλ̓	ἀλλα	CONJ	_	
ὑπὲρ	ὑπέρ	PREP	_	
αὐτάων	αὐτός	PRON	number=PLURAL|gender=MASCULINE|case=GENITIVE	
βαθὺν	βαθύς	ADJ	number=SINGULAR|gender=MASCULINE|case=ACCUSATIVE	
ἠέρα	ἀήρ	NN	number=SINGULAR|gender=MASCULINE|case=ACCUSATIVE	
τέμνον	τέμνω	VB	person=PERSON_3|number=PLURAL|tense=IMP|mood=INDICATIVE|voice=ACTIVE	
ἰόντες	εἶμι	VB	number=PLURAL|tense=PR|mood=PARTICIPLE|voice=ACTIVE|gender=MASCULINE|case=NOMINATIVE	
ἀλλ̓	ἀλλα	CONJ	_	
οὔτις	οὔτις	PRON	number=SINGULAR|gender=MASCULINE|case=NOMINATIVE	
πεῖσαι	πείθω	VB	mood=INFINITIVE|voice=ACTIVE	
δύνατο	δύναμαι	VB	person=PERSON_3|number=SINGULAR|tense=IMP|mood=INDICATIVE	
φρένας	φρήν	NN	number=PLURAL|gender=FEMININE|case=ACCUSATIVE	
οὐδὲ	οὐδὲ	CONJ	_	
νόημα	νόημα	NN	number=SINGULAR|gender=NEUTER|case=ACCUSATIVE	
θυμῷ	θυμός	NN	number=SINGULAR|gender=MASCULINE|case=DATIVE	
χωομένης	χώομαι	VB	number=SINGULAR|tense=PR|mood=PARTICIPLE|gender=FEMININE|case=GENITIVE	
Ῥείης	Ῥέα	NN	number=SINGULAR|gender=FEMININE|case=GENITIVE	
ἠυκόμου	εὔκομος	ADJ	number=SINGULAR|gender=FEMININE|case=GENITIVE	
θύγατερ	θυγάτηρ	NN	number=SINGULAR|gender=FEMININE|case=VOCATIVE	
Δήμητερ	Δήμητηρ	NN	number=SINGULAR|gender=FEMININE|case=VOCATIVE	
ἄνασσα	ἄνασσα	NN	number=SINGULAR|gender=FEMININE|case=VOCATIVE	
εἰδήσεις	εἶδον	VB	person=PERSON_2|number=SINGULAR|tense=FUTURE|mood=INDICATIVE|voice=ACTIVE	
δηρὸν	δηρός	ADJ	number=SINGULAR|gender=NEUTER|case=ACCUSATIVE	
δ̓	δε	CONJ	_	
ἄφθογγος	ἄφθογγος	ADJ	number=SINGULAR|gender=FEMININE|case=NOMINATIVE	
τετιημένη	τετίημαι	VB	number=SINGULAR|tense=PERF|mood=PARTICIPLE|gender=FEMININE|case=NOMINATIVE	
ἧστ̓	ἧμαι	VB	person=PERSON_3|number=SINGULAR|tense=PLUSQUAMPERFECT|mood=INDICATIVE|voice=ACTIVE	
ἐπὶ	ἐπί	PREP	_	
δίφρου	δίφρος	NN	number=SINGULAR|gender=MASCULINE|case=GENITIVE	
οὐδέ	οὐδέ	CONJ	_	
τιν̓	τις	PRON	number=SINGULAR|gender=MASCULINE|case=ACCUSATIVE	
οὔ̓	οὐ	ADV	_	
-τ̓	τε	CONJ	_	
ἔπεϊ	ἔπος	NN	number=SINGULAR|gender=NEUTER|case=DATIVE	
προσπτύσσετο	προσπτύσσω	VB	person=PERSON_3|number=SINGULAR|tense=IMP|mood=INDICATIVE	
οὔτε	οὐτε	CONJ	_	
τι	τις	PRON	number=SINGULAR|gender=NEUTER|case=ACCUSATIVE	
ἔργῳ	ἔργον	NN	number=SINGULAR|gender=NEUTER|case=DATIVE	
ἀλλ̓	ἀλλα	CONJ	_	
ἀγέλαστος	ἀγέλαστος	ADJ	number=SINGULAR|gender=FEMININE|case=NOMINATIVE	
ἄπαστος	ἄπαστος	ADJ	number=SINGULAR|gender=FEMININE|case=NOMINATIVE	
ἐδητύος	ἐδητύς	NN	number=SINGULAR|gender=FEMININE|case=GENITIVE	
ἠδὲ	ἠδέ	CONJ	_	
ποτῆτος	ποτής	NN	number=SINGULAR|gender=FEMININE|case=GENITIVE	
ἧστο	ἧμαι	VB	person=PERSON_3|number=SINGULAR|tense=PLUSQUAMPERFECT|mood=INDICATIVE	
πόθῳ	πόθος	NN	number=SINGULAR|gender=MASCULINE|case=DATIVE	
μινύθουσα	μινύθω	VB	number=SINGULAR|tense=PR|mood=PARTICIPLE|voice=ACTIVE|gender=FEMININE|case=NOMINATIVE	
βαθυζώνοιο	βαθύζωνος	ADJ	number=SINGULAR|gender=FEMININE|case=GENITIVE	
θυγατρός	θυγάτηρ	NN	number=SINGULAR|gender=FEMININE|case=GENITIVE	
πρίν	πρίν	CONJ	_	
γ̓	γε	ADV	_	
ὅτε	ὅτε	ADV	_	
δὴ	δή	ADV	_	
χλεύῃς	χλεύη	NN	number=PLURAL|gender=FEMININE|case=DATIVE	
μιν	μιν	PRON	person=PERSON_3|number=SINGULAR|gender=FEMININE|case=ACCUSATIVE	
Ἰάμβη	Ἰάμβη	NN	number=SINGULAR|gender=FEMININE|case=NOMINATIVE	
κέδν̓	κέδνος	ADJ	number=PLURAL|gender=NEUTER|case=ACCUSATIVE	
εἰδυῖα	οἶδα	VB	number=SINGULAR|tense=PERF|mood=PARTICIPLE|voice=ACTIVE|gender=FEMININE|case=NOMINATIVE	
πολλὰ	πολύς	ADJ	number=PLURAL|gender=NEUTER|case=ACCUSATIVE	
παρασκώπτουσ̓	παρασκώπτω	VB	number=SINGULAR|tense=PR|mood=PARTICIPLE|voice=ACTIVE|gender=FEMININE|case=NOMINATIVE	
ἐτρέψατο	τρέπω	VB	person=PERSON_3|number=SINGULAR|mood=INDICATIVE	
πότνιαν	πότνια	NN	number=SINGULAR|gender=FEMININE|case=ACCUSATIVE	
ἁγνήν	ἁγνός	ADJ	number=SINGULAR|gender=FEMININE|case=ACCUSATIVE	
μειδῆσαι	μειδάω	VB	mood=INFINITIVE|voice=ACTIVE	
γελάσαι	γελάω	VB	mood=INFINITIVE|voice=ACTIVE	
τε	τε	CONJ	_	
καὶ	καί	CONJ	_	
ἵλαον	ἵλαος	ADJ	number=SINGULAR|gender=MASCULINE|case=ACCUSATIVE	
σχεῖν	ἔχω	VB	mood=INFINITIVE|voice=ACTIVE	
θυμόν	θυμός	NN	number=SINGULAR|gender=MASCULINE|case=ACCUSATIVE	
ταὶ	ὁ	PRON	number=PLURAL|gender=FEMININE|case=NOMINATIVE	
δὲ	δὲ	CONJ	_	
φαεινὰ	φαεινός	ADJ	number=PLURAL|gender=NEUTER|case=ACCUSATIVE	
πλησάμεναι	πίμπλημι	VB	number=PLURAL|mood=PARTICIPLE|gender=FEMININE|case=NOMINATIVE	
ὕδατος	ὕδωρ	NN	number=SINGULAR|gender=NEUTER|case=GENITIVE	
φέρον	φέρω	VB	person=PERSON_3|number=PLURAL|tense=IMP|mood=INDICATIVE|voice=ACTIVE	
ἄγγεα	ἄγγος	NN	number=PLURAL|gender=NEUTER|case=ACCUSATIVE	
κυδιάουσαι	κυδιάω	VB	number=PLURAL|tense=PR|mood=PARTICIPLE|voice=ACTIVE|gender=FEMININE|case=NOMINATIVE	
πολλὰ	πολλὰ	ADV	_	
δ̓	δε	CONJ	_	
ἄῤ	ἄρα	ADV	_	
ἀμφαγάπησε	ἀμφαγαπάω	VB	person=PERSON_3|number=SINGULAR|mood=INDICATIVE|voice=ACTIVE	
κόρην	κόρη	NN	number=SINGULAR|gender=FEMININE|case=ACCUSATIVE	
Δημήτερος	Δημήτηρ	NN	number=SINGULAR|gender=FEMININE|case=GENITIVE	
ἁγνήν	ἁγνός	ADJ	number=SINGULAR|gender=FEMININE|case=ACCUSATIVE	
ἐβόησα	βοάω	VB	person=PERSON_1|number=SINGULAR|mood=INDICATIVE|voice=ACTIVE	
δ̓	δε	CONJ	_	
ἄῤ	ἄρα	ADV	_	
ὄρθια	ὄρθια	ADV	_	
φωνῇ	φωνή	NN	number=SINGULAR|gender=FEMININE|case=DATIVE	
ἣ	ὁ	PRON	number=SINGULAR|gender=FEMININE|case=NOMINATIVE	
δή	δή	ADV	_	
οἱ	ἕ	PRON	number=SINGULAR|gender=FEMININE|case=DATIVE	
καὶ	καὶ	ADV	_	
ἔπειτα	ἔπειτα	ADV	_	
μεθύστερον	μεθύστερος	ADJ	number=SINGULAR|gender=NEUTER|case=ACCUSATIVE	
εὔαδεν	ἁνδάνω	VB	person=PERSON_3|number=SINGULAR|mood=INDICATIVE|voice=ACTIVE	
ὀργαῖς	ὀργή	NN	number=PLURAL|gender=FEMININE|case=DATIVE	
παῖδα	παῖς	NN	number=SINGULAR|gender=MASCULINE|case=ACCUSATIVE	
δέ	δέ	CONJ	_	
τοι	τοι	ADV	_	
πρόφρων	πρόφρων	ADJ	number=SINGULAR|gender=FEMININE|case=NOMINATIVE	
ὑποδέξομαι	ὑποδέχομαι	VB	person=PERSON_1|number=SINGULAR|tense=FUTURE|mood=INDICATIVE	
ὥς	ὡς	CONJ	_	
με	ἐγώ	PRON	person=PERSON_1|number=SINGULAR|gender=FEMININE|case=ACCUSATIVE	
κελεύεις	κελεύω	VB	person=PERSON_2|number=SINGULAR|tense=PR|mood=INDICATIVE|voice=ACTIVE	
θρέψω	τρέφω	VB	person=PERSON_1|number=SINGULAR|tense=FUTURE|mood=INDICATIVE|voice=ACTIVE	
κ-	ἄν	ADV	_	
οὔ	οὐ	ADV	_	
μιν	μιν	PRON	person=PERSON_3|number=SINGULAR|gender=MASCULINE|case=ACCUSATIVE	
ἔολπα	ἔλπω	VB	person=PERSON_1|number=SINGULAR|tense=PERF|mood=INDICATIVE|voice=ACTIVE	
κακοφραδίῃσι	κακοφραδία	NN	number=PLURAL|gender=FEMININE|case=DATIVE	
τιθήνης	τιθήνη	NN	number=SINGULAR|gender=FEMININE|case=GENITIVE	
οὔ	οὐ	ADV	_	
-τ̓	τε	CONJ	_	
ἄῤ	ἄρα	ADV	_	
ἐπηλυσίη	ἐπηλυσία	NN	number=SINGULAR|gender=FEMININE|case=NOMINATIVE	
δηλήσεται	δηλέομαι	VB	person=PERSON_3|number=SINGULAR|tense=FUTURE|mood=INDICATIVE	
οὔθ̓	οὔτε	CONJ	_	
ὑποτάμνον	ὑποτέμνω	VB	number=SINGULAR|tense=PR|mood=PARTICIPLE|voice=ACTIVE|gender=NEUTER|case=NOMINATIVE	
πότνια	πότνια	NN	number=SINGULAR|gender=FEMININE|case=VOCATIVE	
Δημήτηρ	Δημήτηρ	NN	number=SINGULAR|gender=FEMININE|case=VOCATIVE	
ὡρηφόρε	ὡρηφόρος	ADJ	number=SINGULAR|gender=FEMININE|case=VOCATIVE	
ἀγλαόδωρε	ἀγλαόδωρος	ADJ	number=SINGULAR|gender=FEMININE|case=VOCATIVE	
τίς	τις	PRON	number=SINGULAR|gender=MASCULINE|case=NOMINATIVE	
θεῶν	θεὸς	NN	number=PLURAL|gender=MASCULINE|case=GENITIVE	
οὐρανίων	οὐράνιος	ADJ	number=PLURAL|gender=MASCULINE|case=GENITIVE	
ἠὲ	ἠέ	CONJ	_	
θνητῶν	θνητός	ADJ	number=PLURAL|gender=MASCULINE|case=GENITIVE	
ἀνθρώπων	ἄνθρωπος	NN	number=PLURAL|gender=MASCULINE|case=GENITIVE	
ἥρπασε	ἁρπάζω	VB	person=PERSON_3|number=SINGULAR|mood=INDICATIVE|voice=ACTIVE	
Περσεφόνην	Περσεφόνη	NN	number=SINGULAR|gender=FEMININE|case=ACCUSATIVE	
καὶ	καί	CONJ	_	
σὸν	σός	ADJ	number=SINGULAR|gender=MASCULINE|case=ACCUSATIVE	
φίλον	φίλος	ADJ	number=SINGULAR|gender=MASCULINE|case=ACCUSATIVE	
ἤκαχε	ἀχεύω	VB	person=PERSON_3|number=SINGULAR|mood=INDICATIVE|voice=ACTIVE	
θυμόν	θυμός	NN	number=SINGULAR|gender=MASCULINE|case=ACCUSATIVE	
αὐτὰρ	αὐτὰρ	CONJ	_	
ἐγὼ	ἐγώ	PRON	person=PERSON_1|number=SINGULAR|gender=MASCULINE|case=NOMINATIVE	
καὶ	καί	CONJ	_	
σεῖο	σύ	PRON	person=PERSON_2|number=SINGULAR|case=GENITIVE	
καὶ	καί	CONJ	_	
ἄλλης	ἄλλος	PRON	number=SINGULAR|gender=FEMININE|case=GENITIVE	
μνήσομ̓	μιμνήσκω	VB	person=PERSON_1|number=SINGULAR|mood=SUBJUNCTIVE	
ἀοιδῆς	ἀοιδή	NN	number=SINGULAR|gender=FEMININE|case=GENITIVE	
ἣ	ὁ	PRON	number=SINGULAR|gender=FEMININE|case=NOMINATIVE	
δ̓	δε	CONJ	_	
ἐπένευσε	ἐπινεύω	VB	person=PERSON_3|number=SINGULAR|mood=INDICATIVE|voice=ACTIVE	
καρήατι	κάρα	NN	number=SINGULAR|gender=NEUTER|case=DATIVE	
ἄνωγε	ἄνωγα	VB	person=PERSON_3|number=SINGULAR|tense=IMP|mood=INDICATIVE|voice=ACTIVE	
δ̓	δε	CONJ	_	
ἄῤ	ἄρα	ADV	_	
ἄλφι	ἄλφιτον	NN	number=SINGULAR|gender=NEUTER|case=ACCUSATIVE	
καὶ	καί	CONJ	_	
ὕδωρ	ὕδωρ	NN	number=SINGULAR|gender=NEUTER|case=ACCUSATIVE	
δοῦναι	δίδωμι	VB	mood=INFINITIVE|voice=ACTIVE	
μίξασαν	μίγνυμι	VB	number=SINGULAR|mood=PARTICIPLE|voice=ACTIVE|gender=FEMININE|case=ACCUSATIVE	
πιέμεν	πίνω	VB	mood=INFINITIVE|voice=ACTIVE	
γλήχωνι	βλήχων	NN	number=SINGULAR|gender=FEMININE|case=DATIVE	
τερείνῃ	τέρην	ADJ	number=SINGULAR|gender=FEMININE|case=DATIVE	
ὣς	ὡς	CONJ	_	
ἄρα	ἄρα	ADV	_	
φωνήσασα	φωνέω	VB	number=SINGULAR|mood=PARTICIPLE|voice=ACTIVE|gender=FEMININE|case=NOMINATIVE	
θυώδεϊ	θυώδης	ADJ	number=SINGULAR|gender=FEMININE|case=DATIVE	
δέξατο	δείκνυμι	VB	person=PERSON_3|number=SINGULAR|mood=INDICATIVE	
κόλπῳ	κόλπος	NN	number=SINGULAR|gender=MASCULINE|case=DATIVE	
χείρεσσ̓	χείρ	NN	number=PLURAL|gender=FEMININE|case=DATIVE	
ἀθανάτῃσι	ἀθάνατος	ADJ	number=PLURAL|gender=FEMININE|case=DATIVE	
ὡς	ὡς	CONJ	_	
δέ	δέ	CONJ	_	
μ̓	εγω	PRON	number=SINGULAR|gender=FEMININE|case=ACCUSATIVE	
ἀναρπάξας	ἀναρπάζω	VB	number=SINGULAR|mood=PARTICIPLE|voice=ACTIVE|gender=MASCULINE|case=NOMINATIVE	
Κρονίδεω	Κρονίδης	NN	number=SINGULAR|gender=MASCULINE|case=GENITIVE	
πυκινὴν	πυκνός	ADJ	number=SINGULAR|gender=FEMININE|case=ACCUSATIVE	
διὰ	διά	PREP	_	
μῆτιν	μῆτις	NN	number=SINGULAR|gender=FEMININE|case=ACCUSATIVE	
ᾤχετο	οἴχομαι	VB	person=PERSON_3|number=SINGULAR|tense=IMP|mood=INDICATIVE	
πατρὸς	πατήρ	NN	number=SINGULAR|gender=MASCULINE|case=GENITIVE	
ἐμοῖο	ἐμός	ADJ	number=SINGULAR|gender=MASCULINE|case=GENITIVE	
φέρων	φέρω	VB	number=SINGULAR|tense=PR|mood=PARTICIPLE|voice=ACTIVE|gender=MASCULINE|case=NOMINATIVE	
ὑπὸ	ὑπό	PREP	_	
κεύθεα	κεῦθος	NN	number=PLURAL|gender=NEUTER|case=ACCUSATIVE	
γαίης	γαῖα	NN	number=SINGULAR|gender=FEMININE|case=GENITIVE	
ἐξερέω	ἐξερέω	VB	person=PERSON_1|number=SINGULAR|tense=FUTURE|mood=INDICATIVE|voice=ACTIVE	
καὶ	καί	CONJ	_	
πάντα	πᾶς	ADJ	number=PLURAL|gender=NEUTER|case=ACCUSATIVE	
διίξομαι	διικνέομαι	VB	person=PERSON_1|number=SINGULAR|tense=FUTURE|mood=INDICATIVE	
ὡς	ὡς	CONJ	_	
ἐρεείνεις	ἐρεείνω	VB	person=PERSON_2|number=SINGULAR|tense=PR|mood=INDICATIVE|voice=ACTIVE	
καί	καί	CONJ	_	
κέν	ἄν	ADV	_	
μιν	μιν	PRON	person=PERSON_3|number=SINGULAR|gender=MASCULINE|case=ACCUSATIVE	
ποίησεν	ποιέω	VB	person=PERSON_3|number=SINGULAR|mood=INDICATIVE|voice=ACTIVE	
ἀγήρων	ἀγήραος	NN	number=SINGULAR|gender=MASCULINE|case=ACCUSATIVE	
τ̓	τε	CONJ	_	
ἀθάνατόν	ἀθάνατος	ADJ	number=SINGULAR|gender=MASCULINE|case=ACCUSATIVE	
τε	τε	CONJ	_	
εἰ	εἰ	CONJ	_	
μὴ	μὴ	ADV	_	
ἄῤ	ἄρα	ADV	_	
ἀφραδίῃσιν	ἀφραδία	NN	number=PLURAL|gender=FEMININE|case=DATIVE	
ἐύζωνος	εὔζωνος	ADJ	number=SINGULAR|gender=FEMININE|case=NOMINATIVE	
Μετάνειρα	Μετανείρα	NN	number=SINGULAR|gender=FEMININE|case=NOMINATIVE	
νύκτ̓	νύξ	NN	number=SINGULAR|gender=FEMININE|case=ACCUSATIVE	
ἐπιτηρήσασα	ἐπιτηρέω	VB	number=SINGULAR|mood=PARTICIPLE|voice=ACTIVE|gender=FEMININE|case=NOMINATIVE	
θυώδεος	θυώδης	ADJ	number=SINGULAR|gender=MASCULINE|case=GENITIVE	
ἐκ	ἐκ	PREP	_	
θαλάμοιο	θάλαμος	NN	number=SINGULAR|gender=MASCULINE|case=GENITIVE	
σκέψατο	σκέπτομαι	VB	person=PERSON_3|number=SINGULAR|mood=INDICATIVE	
τὴν	ὁ	PRON	number=SINGULAR|gender=FEMININE|case=ACCUSATIVE	
δ̓	δε	CONJ	_	
οὐκ	οὐ	ADV	_	
ἠμείβετο	ἀμείβω	VB	person=PERSON_3|number=SINGULAR|tense=IMP|mood=INDICATIVE	
μύθῳ	μῦθος	NN	number=SINGULAR|gender=MASCULINE|case=DATIVE	
Ῥείης	Ῥέα	NN	number=SINGULAR|gender=FEMININE|case=GENITIVE	
ἠυκόμου	εὔκομος	ADJ	number=SINGULAR|gender=FEMININE|case=GENITIVE	
θυγάτηρ	θυγάτηρ	NN	number=SINGULAR|gender=FEMININE|case=NOMINATIVE	
ἀλλ̓	ἀλλα	CONJ	_	
ὦκα	ὦκα	ADV	_	
σὺν	σύν	PREP	_	
αὐτῇ	αὐτός	PRON	number=SINGULAR|gender=FEMININE|case=DATIVE	
ἤιξ̓	αισσω	VB	person=PERSON_3|number=SINGULAR|mood=INDICATIVE|voice=ACTIVE	
αἰθομένας	αἴθω	VB	number=PLURAL|tense=PR|mood=PARTICIPLE|gender=FEMININE|case=ACCUSATIVE	
δαΐδας	δαίς	NN	number=PLURAL|gender=FEMININE|case=ACCUSATIVE	
μετὰ	μετά	PREP	_	
χερσὶν	χείρ	NN	number=PLURAL|gender=FEMININE|case=DATIVE	
ἔχουσα	ἔχω	VB	number=SINGULAR|tense=PR|mood=PARTICIPLE|voice=ACTIVE|gender=FEMININE|case=NOMINATIVE	
βῆ	βαίνω	VB	person=PERSON_3|number=SINGULAR|mood=INDICATIVE|voice=ACTIVE	
δὲ	δὲ	CONJ	_	
φέρων	φέρω	VB	number=SINGULAR|tense=PR|mood=PARTICIPLE|voice=ACTIVE|gender=MASCULINE|case=NOMINATIVE	
ὑπὸ	ὑπό	PREP	_	
γαῖαν	γαῖα	NN	number=SINGULAR|gender=FEMININE|case=ACCUSATIVE	
ἐν	ἐν	PREP	_	
ἅρμασι	ἅρμα	NN	number=PLURAL|gender=NEUTER|case=DATIVE	
χρυσείοισι	χρύσεος	ADJ	number=PLURAL|gender=NEUTER|case=DATIVE	
πόλλ̓	πόλλα	ADV	_	
ἀεκαζομένην	ἀεκαζόμενος	ADJ	number=SINGULAR|gender=FEMININE|case=ACCUSATIVE	
μείδησεν	μειδάω	VB	person=PERSON_3|number=SINGULAR|mood=INDICATIVE|voice=ACTIVE	
δὲ	δὲ	CONJ	_	
ἄναξ	ἄναξ	NN	number=SINGULAR|gender=MASCULINE|case=NOMINATIVE	
ἐνέρων	ἔνεροι	NN	number=PLURAL|gender=MASCULINE|case=GENITIVE	
Ἀιδωνεὺς	Ἅιδης	NN	number=SINGULAR|gender=MASCULINE|case=NOMINATIVE	
ὀφρύσιν	ὀφρύς	NN	number=PLURAL|gender=FEMININE|case=DATIVE	
οὐδ̓	οὐδε	CONJ	_	
ἀπίθησε	ἀπιθέω	VB	person=PERSON_3|number=SINGULAR|mood=INDICATIVE|voice=ACTIVE	
Διὸς	Ζεύς	NN	number=SINGULAR|gender=MASCULINE|case=GENITIVE	
βασιλῆος	βασιλεύς	NN	number=SINGULAR|gender=MASCULINE|case=GENITIVE	
ἐφετμῇς	ἐφετμή	NN	number=PLURAL|gender=FEMININE|case=DATIVE	
α[ἶψα	αἶψα	ADV	_	
δὲ	δὲ	CONJ	_	
κα]ρπὸν	καρπός	NN	number=SINGULAR|gender=MASCULINE|case=ACCUSATIVE	
ἄεξε	ἀέξω	VB	person=PERSON_2|number=SINGULAR|tense=PR|mood=IMPERATIVE|voice=ACTIVE	
φερέσβιον	φερέσβιος	ADJ	number=SINGULAR|gender=MASCULINE|case=ACCUSATIVE	
ἀνθρώποισιν	ἄνθρωπος	NN	number=PLURAL|gender=MASCULINE|case=DATIVE	
ὣς	ὡς	CONJ	_	
φάτ̓	φῆμι	VB	person=PERSON_3|number=SINGULAR|mood=INDICATIVE|voice=ACTIVE	
ὀδυρομένη	ὀδύρομαι	VB	number=SINGULAR|tense=PR|mood=PARTICIPLE|gender=FEMININE|case=NOMINATIVE	
οὔ	οὐ	ADV	_	
τοι	τοι	ADV	_	
ἀεικὴς	ἀεικής	ADJ	number=SINGULAR|gender=MASCULINE|case=NOMINATIVE	
γαμβρὸς	γαμβρός	NN	number=SINGULAR|gender=MASCULINE|case=NOMINATIVE	
ἐν	ἐν	PREP	_	
ἀθανάτοις	ἀθάνατος	ADJ	number=PLURAL|gender=MASCULINE|case=DATIVE	
Πολυσημάντωρ	Πολυσημάντωρ	ADJ	number=SINGULAR|gender=MASCULINE|case=NOMINATIVE	
Ἀιδωνεύς	Ἅιδης	NN	number=SINGULAR|gender=MASCULINE|case=NOMINATIVE	
αὐτοκασίγνητος	αὐτοκασίγνητος	NN	number=SINGULAR|gender=MASCULINE|case=NOMINATIVE	
καὶ	καί	CONJ	_	
ὁμόσπορος	ὁμόσπορος	ADJ	number=SINGULAR|gender=MASCULINE|case=NOMINATIVE	
ἐστι	εἰμί	VB	person=PERSON_3|number=SINGULAR|tense=PR|mood=INDICATIVE|voice=ACTIVE	
ὄργια	ὄργια	NN	number=PLURAL|gender=NEUTER|case=ACCUSATIVE	
δ̓	δε	CONJ	_	
αὐτὴ	αὐτός	PRON	number=SINGULAR|gender=FEMININE|case=NOMINATIVE	
ἐγὼν	ἐγώ	PRON	person=PERSON_1|number=SINGULAR|gender=FEMININE|case=NOMINATIVE	
ὑποθήσομαι	ὑποτίθημι	VB	person=PERSON_1|number=SINGULAR|tense=FUTURE|mood=INDICATIVE	
ὡς	ὡς	CONJ	_	
ἂν	ἄν	ADV	_	
ἔπειτα	ἔπειτα	ADV	_	
εὐαγέως	εὐαγης	ADV	_	
ἔρδοντες	ἔρδω	VB	number=PLURAL|tense=PR|mood=PARTICIPLE|voice=ACTIVE|gender=MASCULINE|case=NOMINATIVE	
ἐμὸν	ἐμός	ADJ	number=SINGULAR|gender=MASCULINE|case=ACCUSATIVE	
νόον	νόος	NN	number=SINGULAR|gender=MASCULINE|case=ACCUSATIVE	
ἱλάσκοισθε	ἱλάσκομαι	VB	person=PERSON_2|number=PLURAL|tense=PR	
εἰ	εἰ	CONJ	_	
δ̓	δε	CONJ	_	
ἐθέλεις	ἐθέλω	VB	person=PERSON_2|number=SINGULAR|tense=PR|mood=INDICATIVE|voice=ACTIVE	
ἐπίμεινον	ἐπιμένω	VB	person=PERSON_2|number=SINGULAR|mood=IMPERATIVE|voice=ACTIVE	
ἵνα	ἵνα	CONJ	_	
πρὸς	πρός	PREP	_	
δώματα	δῶμα	NN	number=PLURAL|gender=NEUTER|case=ACCUSATIVE	
πατρὸς	πατήρ	NN	number=SINGULAR|gender=MASCULINE|case=GENITIVE	
ἔλθωμεν	ἔρχομαι	VB	person=PERSON_1|number=PLURAL|mood=SUBJUNCTIVE|voice=ACTIVE	
καὶ	καί	CONJ	_	
μητρὶ	μήτηρ	NN	number=SINGULAR|gender=FEMININE|case=DATIVE	
βαθυζώνῳ	βαθύζωνος	ADJ	number=SINGULAR|gender=FEMININE|case=DATIVE	
Μετανείρῃ	Μετανείρα	NN	number=SINGULAR|gender=FEMININE|case=DATIVE	
εἴπωμεν	εἶπον	VB	person=PERSON_1|number=PLURAL|mood=SUBJUNCTIVE|voice=ACTIVE	
τάδε	ὅδε	PRON	number=PLURAL|gender=NEUTER|case=ACCUSATIVE	
πάντα	πᾶς	ADJ	number=PLURAL|gender=NEUTER|case=ACCUSATIVE	
διαμπερές	διαμπερές	ADV	_	
αἴ	εἰ	CONJ	_	
κέ	ἄν	ADV	_	
σ̓	συ	PRON	number=SINGULAR|gender=FEMININE|case=ACCUSATIVE	
ἀνώγῃ	ἄνωγα	VB	person=PERSON_3|number=SINGULAR|tense=PERF|mood=SUBJUNCTIVE|voice=ACTIVE	
ἡμέτερόνδ̓	ἡμέτερόνδε	ADV	_	
ἰέναι	εἶμι	VB	tense=PR|mood=INFINITIVE|voice=ACTIVE	
μἠ	μη	CONJ	_	
-δ̓	δε	CONJ	_	
ἄλλων	ἄλλος	PRON	number=PLURAL|gender=MASCULINE|case=GENITIVE	
δώματ̓	δῶμα	NN	number=PLURAL|gender=NEUTER|case=ACCUSATIVE	
ἐρευνᾶν	ἐρευνάω	VB	tense=PR|mood=INFINITIVE|voice=ACTIVE	
τοῦτο	οὗτος	PRON	number=SINGULAR|gender=NEUTER|case=ACCUSATIVE	
δέ	δέ	CONJ	_	
μοι	ἐγώ	PRON	person=PERSON_1|number=SINGULAR|gender=FEMININE|case=DATIVE	
σαφέως	σαφής	ADJ	_	
ὑποθήκατε	ὑποτίθημι	VB	person=PERSON_2|number=PLURAL|mood=IMPERATIVE|voice=ACTIVE	
ὄφρα	ὄφρα	CONJ	_	
πύθωμαι	πύθω	VB	person=PERSON_1|number=SINGULAR|tense=PR|mood=SUBJUNCTIVE|voice=PASSIVE	
προφρονέως	πρόφρων	ADV	_	
φίλα	φίλος	ADJ	number=PLURAL|gender=NEUTER|case=VOCATIVE	
τέκνα	τέκνον	NN	number=PLURAL|gender=NEUTER|case=VOCATIVE	
τέων	τέος	ADJ	number=PLURAL|gender=MASCULINE|case=GENITIVE	
πρὸς	πρός	PREP	_	
δώμαθ̓	δῶμα	NN	number=PLURAL|gender=NEUTER|case=ACCUSATIVE	
ἵκωμαι	ἱκνέομαι	VB	person=PERSON_1|number=SINGULAR|mood=SUBJUNCTIVE	
ἀνέρος	ἀνήρ	NN	number=SINGULAR|gender=MASCULINE|case=GENITIVE	
ἠδὲ	ἠδέ	CONJ	_	
γυναικός	γυνή	NN	number=SINGULAR|gender=FEMININE|case=GENITIVE	
ἵνα	ἵνα	CONJ	_	
σφίσιν	σφεῖς	PRON	number=PLURAL|gender=MASCULINE|case=DATIVE	
ἐργάζωμαι	ἐργάζομαι	VB	person=PERSON_1|number=SINGULAR|tense=PR|mood=SUBJUNCTIVE	
πρόφρων	πρόφρων	ADJ	number=SINGULAR|gender=FEMININE|case=NOMINATIVE	
οἷα	οἷος	ADJ	number=PLURAL|gender=NEUTER|case=NOMINATIVE	
γυναικὸς	γυνή	NN	number=SINGULAR|gender=FEMININE|case=GENITIVE	
ἀφήλικος	ἀφῆλιξ	ADJ	number=SINGULAR|gender=FEMININE|case=GENITIVE	
ἔργα	ἔργον	NN	number=PLURAL|gender=NEUTER|case=NOMINATIVE	
τέτυκται	τεύχω	VB	person=PERSON_3|number=SINGULAR|tense=PERF|mood=INDICATIVE	
οὐ	οὐ	ADV	_	
γὰρ	γάρ	ADV	_	
θεμιτόν	θεμιτός	ADJ	number=SINGULAR|gender=NEUTER|case=ACCUSATIVE	
οἱ	ἕ	PRON	number=SINGULAR|gender=FEMININE|case=DATIVE	
ἔφασκε	φάσκω	VB	person=PERSON_3|number=SINGULAR|tense=IMP|mood=INDICATIVE|voice=ACTIVE	
πίνειν	πίνω	VB	tense=PR|mood=INFINITIVE|voice=ACTIVE	
οἶνον	οἶνον	NN	number=SINGULAR|gender=NEUTER|case=ACCUSATIVE	
ἐρυθρόν	ἐρυθρός	ADJ	number=SINGULAR|gender=NEUTER|case=ACCUSATIVE	
εἰναι	εἰναι	VB	tense=PR|mood=INFINITIVE|voice=ACTIVE	
ὣς	ὡς	CONJ	_	
ἄῤ	ἄρα	ADV	_	
ἔφη	φημί	VB	person=PERSON_3|number=SINGULAR|tense=IMP|mood=INDICATIVE|voice=ACTIVE	
Ἑκάτη	Ἑκάτη	NN	number=SINGULAR|gender=FEMININE|case=NOMINATIVE	
οὔ	οὐ	ADV	_	
τοι	τοι	ADV	_	
ἀεικὲς	ἀεικής	ADJ	number=SINGULAR|gender=NEUTER|case=NOMINATIVE	
ὑμῖν	σύ	PRON	person=PERSON_2|number=PLURAL|case=DATIVE	
εἰρομένῃσιν	εἴρω	VB	number=PLURAL|tense=PR|mood=PARTICIPLE|gender=FEMININE|case=DATIVE	
ἀληθέα	ἀληθής	ADJ	number=PLURAL|gender=NEUTER|case=ACCUSATIVE	
μυθήσασθαι	μυθέομαι	VB	mood=INFINITIVE	
ὲστιν	εἰμί	VB	person=PERSON_3|number=SINGULAR|tense=PR|mood=INDICATIVE|voice=ACTIVE	
ἐπεὶ	ἐπεί	CONJ	_	
μέγα	μέγας	ADJ	number=SINGULAR|gender=NEUTER|case=NOMINATIVE	
μήδεται	μήδομαι	VB	person=PERSON_3|number=SINGULAR|tense=PR|mood=INDICATIVE	
ἔργον	ἔργον	NN	number=SINGULAR|gender=NEUTER|case=NOMINATIVE	
φθῖσαι	φθίω	VB	person=PERSON_3|number=SINGULAR|voice=ACTIVE	
φῦλ̓	φῦλον	NN	number=PLURAL|gender=NEUTER|case=ACCUSATIVE	
ἀμενηνὰ	ἀμενηνός	ADJ	number=PLURAL|gender=NEUTER|case=ACCUSATIVE	
χαμαιγενέων	χαμαιγενής	ADJ	number=PLURAL|gender=MASCULINE|case=GENITIVE	
ἀνθρώπων	ἄνθρωπος	NN	number=PLURAL|gender=MASCULINE|case=GENITIVE	
σπέρμ̓	σπέρμα	NN	number=PLURAL|gender=NEUTER|case=ACCUSATIVE	
ὑπὸ	ὑπό	PREP	_	
γῆς	γῆ	NN	number=SINGULAR|gender=FEMININE|case=GENITIVE	
κρύπτουσα	κρύπτω	VB	number=SINGULAR|tense=PR|mood=PARTICIPLE|voice=ACTIVE|gender=FEMININE|case=NOMINATIVE	
καταφθινύθουσα	καταφθινύθω	VB	number=SINGULAR|tense=PR|mood=PARTICIPLE|voice=ACTIVE|gender=FEMININE|case=NOMINATIVE	
δὲ	δὲ	CONJ	_	
τιμὰς	τιμή	NN	number=PLURAL|gender=FEMININE|case=ACCUSATIVE	
ἀθανάτων	ἀθάνατος	ADJ	number=PLURAL|gender=MASCULINE|case=GENITIVE	
τοῖς	ὁ	PRON	number=PLURAL|gender=NEUTER|case=DATIVE	
δὲ	δὲ	CONJ	_	
μέγα	μέγας	ADJ	number=SINGULAR|gender=NEUTER|case=NOMINATIVE	
θαῦμ̓	θαῦμα	NN	number=SINGULAR|gender=NEUTER|case=NOMINATIVE	
ἐτέτυκτο	τεύχω	VB	person=PERSON_3|number=SINGULAR|tense=PLUSQUAMPERFECT|mood=INDICATIVE	
ὡς	ὡς	CONJ	_	
προθαλὴς	προθαλής	ADJ	number=SINGULAR|gender=MASCULINE|case=NOMINATIVE	
τελέθεσκε	τελέθω	VB	person=PERSON_3|number=SINGULAR|tense=IMP|mood=INDICATIVE|voice=ACTIVE	
νύκτας	νύξ	NN	number=PLURAL|gender=FEMININE|case=ACCUSATIVE	
δὲ	δὲ	CONJ	_	
κρύπτεσκε	κρύπτω	VB	person=PERSON_3|number=SINGULAR|tense=IMP|mood=INDICATIVE|voice=ACTIVE	
πυρὸς	πῦρ	NN	number=SINGULAR|gender=NEUTER|case=GENITIVE	
μένει	μένος	NN	number=SINGULAR|gender=NEUTER|case=DATIVE	
ἠύτε	ἠύτε	CONJ	_	
δαλὸν	δαλός	NN	number=SINGULAR|gender=MASCULINE|case=ACCUSATIVE	
λάθρα	λάθρῃ	ADV	_	
φίλων	φίλος	ADJ	number=PLURAL|gender=NEUTER|case=GENITIVE	
γονέων	γονάω	VB	number=SINGULAR|tense=PR|mood=PARTICIPLE|voice=ACTIVE|gender=MASCULINE|case=NOMINATIVE	
τοὶ	τοι	ADV	_	
δ̓	δε	CONJ	_	
ὑπ̓	ὑπο	PREP	_	
ὀμοκλῆς	ὁμοκλή	NN	number=SINGULAR|gender=FEMININE|case=GENITIVE	
ῥίμφα	ῥίμφα	ADV	_	
φέρον	φέρω	VB	person=PERSON_3|number=PLURAL|tense=IMP|mood=INDICATIVE|voice=ACTIVE	
θοὸν	θοός	ADJ	number=SINGULAR|gender=NEUTER|case=ACCUSATIVE	
ἅρμα	ἅρμα	NN	number=SINGULAR|gender=NEUTER|case=ACCUSATIVE	
τανύπτεροι	τανύπτερος	ADJ	number=PLURAL|gender=MASCULINE|case=NOMINATIVE	
ὥστ̓	ὥστε	CONJ	_	
οἰωνοί	οἰωνός	NN	number=PLURAL|gender=MASCULINE|case=NOMINATIVE	
ἣ	ὁ	PRON	number=SINGULAR|gender=FEMININE|case=NOMINATIVE	
δὲ	δὲ	CONJ	_	
Ζηνὶ	Ζεύς	NN	number=SINGULAR|gender=MASCULINE|case=DATIVE	
κελαινεφέι	κελαινεφής	ADJ	number=SINGULAR|case=DATIVE	
Κρονίωνι	Κρονίων	NN	number=SINGULAR|gender=MASCULINE|case=DATIVE	
πείθετο	πείθω	VB	person=PERSON_3|number=SINGULAR|tense=IMP|mood=INDICATIVE	
καὶ	καί	CONJ	_	
τὸ	ὁ		number=SINGULAR|gender=NEUTER|case=ACCUSATIVE	
μεσηγὺ	μεσηγύ	ADV	_	
διέδραμεν	διατρέχω	VB	person=PERSON_3|number=SINGULAR|mood=INDICATIVE|voice=ACTIVE	
ὦκα	ὦκα	ADV	_	
πόδεσσιν	πούς	NN	number=PLURAL|gender=MASCULINE|case=DATIVE	
ἵκετο	ἱκνέομαι	VB	person=PERSON_3|number=SINGULAR|mood=INDICATIVE	
δὲ	δὲ	CONJ	_	
πτολίεθρον	πτολίεθρον	NN	number=SINGULAR|gender=NEUTER|case=ACCUSATIVE	
Ἐλευσῖνος	Ἐλευσίς	NN	number=SINGULAR|gender=FEMININE|case=GENITIVE	
θυοέσσης	θυόεις	ADJ	number=SINGULAR|gender=FEMININE|case=GENITIVE	
εὗρεν	εὑρίσκω	VB	person=PERSON_3|number=SINGULAR|mood=INDICATIVE|voice=ACTIVE	
δ̓	δε	CONJ	_	
ἐν	ἐν	PREP	_	
νηῷ	ναός	NN	number=SINGULAR|gender=MASCULINE|case=DATIVE	
Δημήτερα	Δημήτηρ	NN	number=SINGULAR|gender=FEMININE|case=ACCUSATIVE	
κυανόπεπλον	κυανόπεπλος	ADJ	number=SINGULAR|gender=FEMININE|case=ACCUSATIVE	
καί	καί	CONJ	_	
μιν	μιν	PRON	person=PERSON_3|number=SINGULAR|gender=FEMININE|case=ACCUSATIVE	
φωνήσασ̓	φωνέω	VB	number=SINGULAR|mood=PARTICIPLE|voice=ACTIVE|gender=FEMININE|case=NOMINATIVE	
ἔπεα	ἔπος	NN	number=PLURAL|gender=NEUTER|case=ACCUSATIVE	
πτερόεντα	πτερόεις	ADJ	number=PLURAL|gender=NEUTER|case=ACCUSATIVE	
προσηύδα	προσαυδάω	VB	person=PERSON_3|number=SINGULAR|tense=IMP|mood=INDICATIVE|voice=ACTIVE	
τὸ	ὁ	PRON	number=SINGULAR|gender=NEUTER|case=ACCUSATIVE	
γὰρ	γάρ	ADV	_	
θέτο	τίθημι	VB	person=PERSON_3|number=SINGULAR|mood=INDICATIVE	
πότνια	πότνια	NN	number=SINGULAR|gender=FEMININE|case=NOMINATIVE	
μήτηρ	μήτηρ	NN	number=SINGULAR|gender=FEMININE|case=NOMINATIVE	
ἀχέων	ἀχέω	VB	number=SINGULAR|tense=PR|mood=PARTICIPLE|voice=ACTIVE|gender=MASCULINE|case=NOMINATIVE	
δ̓	δε	CONJ	_	
ἀπεπαύετο	ἀποπαύω	VB	person=PERSON_3|number=SINGULAR|tense=IMP|mood=INDICATIVE	
θυμός	θυμός	NN	number=SINGULAR|gender=MASCULINE|case=NOMINATIVE	
περί	περί	ADV	_	
τ̓	τε	CONJ	_	
ἀμφί	ἀμφί	ADV	_	
τε	τε	CONJ	_	
κάλλος	κάλλος	NN	number=SINGULAR|gender=NEUTER|case=NOMINATIVE	
ἄητο	ἄημι	VB	person=PERSON_3|number=SINGULAR|tense=IMP|mood=INDICATIVE	
ἐσσυμένως	ἐσσυμένος	ADV	_	
δ̓	δε	CONJ	_	
ἤιξε	ἀίσσω	VB	person=PERSON_3|number=SINGULAR|mood=INDICATIVE|voice=ACTIVE	
κατ̓	κατα	PREP	_	
Οὐλύμποιο	Ὄλυμπος	NN	number=SINGULAR|gender=MASCULINE|case=GENITIVE	
καρήνων	κάρηνον	NN	number=PLURAL|gender=NEUTER|case=GENITIVE	
ἐς	εἰς	PREP	_	
δ̓	δε	CONJ	_	
ἄρα	ἄρα	ADV	_	
Ῥάριον	Ῥάριος	ADJ	number=SINGULAR|gender=NEUTER|case=ACCUSATIVE	
ἷξε	ἵκω	VB	person=PERSON_3|number=SINGULAR|mood=INDICATIVE|voice=ACTIVE	
φερέσβιον	φερέσβιος	ADJ	number=SINGULAR|gender=NEUTER|case=NOMINATIVE	
οὖθαρ	οὖθαρ	NN	number=SINGULAR|gender=NEUTER|case=NOMINATIVE	
ἀρούρης	ἄρουρα	NN	number=SINGULAR|gender=FEMININE|case=GENITIVE	
τὸ	ὁ		number=SINGULAR|gender=NEUTER|case=NOMINATIVE	
πρίν	πρίν	CONJ	_	
ἀτὰρ	ἀτὰρ	CONJ	_	
τότε	τότε	ADV	_	
γ̓	γε	ADV	_	
οὔτι	οὔτι	ADV	_	
φερέσβιον	φερέσβιος	ADJ	number=SINGULAR|gender=NEUTER|case=ACCUSATIVE	
ἀλλὰ	ἀλλὰ	CONJ	_	
ἕκηλον	ἕκηλος	ADJ	number=SINGULAR|gender=NEUTER|case=ACCUSATIVE	
ἑστήκει	ἵστημι	VB	person=PERSON_3|number=SINGULAR|tense=PLUSQUAMPERFECT|mood=INDICATIVE|voice=ACTIVE	
πανάφυλλον	πανάφυλλος	ADJ	number=SINGULAR|gender=NEUTER|case=ACCUSATIVE	
ὲστιν	εἰμί	VB	person=PERSON_3|number=SINGULAR|tense=PR|mood=INDICATIVE|voice=ACTIVE	
παῖδα	παῖς	NN	number=SINGULAR|gender=MASCULINE|case=ACCUSATIVE	
δέ	δέ	CONJ	_	
μοι	ἐγώ	PRON	person=PERSON_1|number=SINGULAR|gender=FEMININE|case=DATIVE	
τρέφε	τρέφω	VB	person=PERSON_2|number=SINGULAR|tense=PR|mood=IMPERATIVE|voice=ACTIVE	
τόνδε	ὅδε	PRON	number=SINGULAR|gender=MASCULINE|case=ACCUSATIVE	
τὸν	ὁ	PRON	number=SINGULAR|gender=MASCULINE|case=ACCUSATIVE	
ὀψίγονον	ὀψίγονος	ADJ	number=SINGULAR|gender=MASCULINE|case=ACCUSATIVE	
καὶ	καί	CONJ	_	
ἄελπτον	ἄελπτος	ADJ	number=SINGULAR|gender=MASCULINE|case=ACCUSATIVE	
ὤπασαν	ὀπάζω	VB	person=PERSON_3|number=PLURAL|mood=INDICATIVE|voice=ACTIVE	
ἀθάνατοι	ἀθάνατος	ADJ	number=PLURAL|gender=MASCULINE|case=NOMINATIVE	
πολυάρητος	πολυάρητος	ADJ	number=SINGULAR|gender=MASCULINE|case=NOMINATIVE	
δέ	δέ	CONJ	_	
μοί	ἐγώ	PRON	person=PERSON_1|number=SINGULAR|gender=FEMININE|case=DATIVE	
ἐστιν	εἰμί	VB	person=PERSON_3|number=SINGULAR|tense=PR|mood=INDICATIVE|voice=ACTIVE	
οὐδέ	οὐδέ	CONJ	_	
τί	τι	ADV	_	
σε	σύ	PRON	person=PERSON_2|number=SINGULAR|case=ACCUSATIVE	
χρὴ	χρὴ	VB	person=PERSON_2|number=SINGULAR|tense=PR|mood=IMPERATIVE|voice=ACTIVE	
μὰψ	μάψ	ADV	_	
αὔτως	αὔτως	ADV	_	
ἄπλητον	ἄπλητος	ADJ	number=SINGULAR|gender=MASCULINE|case=ACCUSATIVE	
ἔχειν	ἔχω	VB	tense=PR|mood=INFINITIVE|voice=ACTIVE	
χόλον	χόλος	NN	number=SINGULAR|gender=MASCULINE|case=ACCUSATIVE	
τίς	τις	PRON	number=SINGULAR|gender=MASCULINE|case=NOMINATIVE	
πόθεν	πόθεν	ADV	_	
ἐσσί	εἰμί	VB	person=PERSON_2|number=SINGULAR|tense=PR|mood=INDICATIVE|voice=ACTIVE	
γρῆυ	γραῦς	NN	number=SINGULAR|gender=FEMININE|case=VOCATIVE	
παλαιγενέων	παλαιγενής	ADJ	number=PLURAL|gender=MASCULINE|case=GENITIVE	
ἀνθρώπων	ἄνθρωπος	NN	number=PLURAL|gender=MASCULINE|case=GENITIVE	
ὣς	ὣς	CONJ	_	
φάτο	φημί	VB	person=PERSON_3|number=SINGULAR|mood=INDICATIVE	
λισσομένη	λίσσομαι	VB	number=SINGULAR|tense=PR|mood=PARTICIPLE|gender=FEMININE|case=NOMINATIVE	
ἔνθ̓	ἔνθα	ADV	_	
ἐπέβη	ἐπιβαίνω	VB	person=PERSON_3|number=SINGULAR|mood=INDICATIVE|voice=ACTIVE	
πρώτιστον	πρώτιστος	ADJ	number=SINGULAR|gender=NEUTER|case=ACCUSATIVE	
ἀπ̓	ἀπο	PREP	_	
αἰθέρος	αἰθήρ	NN	number=SINGULAR|gender=MASCULINE|case=GENITIVE	
ἀτρυγέτοιο	ἀτρύγετος	ADJ	number=SINGULAR|gender=MASCULINE|case=GENITIVE	
Ἅιδη	Ἅιδης	NN	number=SINGULAR|gender=MASCULINE|case=VOCATIVE	
κυανοχαῖτα	κυανοχαῖτα	ADJ	number=SINGULAR|gender=MASCULINE|case=VOCATIVE	
καταφθιμένοισιν	καταφθίνω	VB	number=PLURAL|mood=PARTICIPLE|gender=MASCULINE|case=DATIVE	
ἀνάσσων	ἀνάσσω	VB	number=SINGULAR|tense=PR|mood=PARTICIPLE|voice=ACTIVE|gender=MASCULINE|case=NOMINATIVE	
Ζεύς	Ζεύς	NN	number=SINGULAR|gender=MASCULINE|case=NOMINATIVE	
με	ἐγώ	PRON	person=PERSON_1|number=SINGULAR|gender=MASCULINE|case=ACCUSATIVE	
πατὴρ	πατήρ	NN	number=SINGULAR|gender=MASCULINE|case=NOMINATIVE	
ἤνωγεν	ἄνωγα	VB	person=PERSON_3|number=SINGULAR|tense=IMP|mood=INDICATIVE|voice=ACTIVE	
ἀγαυὴν	ἀγαυός	ADJ	number=SINGULAR|gender=FEMININE|case=ACCUSATIVE	
Περσεφόνειαν	Περσεφόνεια	NN	number=SINGULAR|gender=FEMININE|case=ACCUSATIVE	
ἐξαγαγεῖν	ἐξάγω	VB	mood=INFINITIVE|voice=ACTIVE	
Ἐρέβευσφι	Ἐρέβευς	NN	number=SINGULAR|gender=MASCULINE|case=DATIVE	
μετὰ	μετά	PREP	_	
σφέας	σφεῖς	PRON	number=PLURAL|gender=MASCULINE|case=ACCUSATIVE	
ὄφρα	ὄφρα	CONJ	_	
ἑ	ἕ	PRON	number=SINGULAR|gender=FEMININE|case=ACCUSATIVE	
μήτηρ	μήτηρ	NN	number=SINGULAR|gender=FEMININE|case=NOMINATIVE	
ὀφθαλμοῖσιν	ὀφθαλμός	NN	number=PLURAL|gender=MASCULINE|case=DATIVE	
ἰδοῦσα	εἶδον	VB	number=SINGULAR|mood=PARTICIPLE|voice=ACTIVE|gender=FEMININE|case=NOMINATIVE	
χόλου	χόλος	NN	number=SINGULAR|gender=MASCULINE|case=GENITIVE	
καὶ	καί	CONJ	_	
μήνιος	μῆνις	NN	number=SINGULAR|gender=FEMININE|case=GENITIVE	
αἰνῆς	αἰνός	ADJ	number=SINGULAR|gender=FEMININE|case=GENITIVE	
ἀθανάτοις	ἀθάνατος	ADJ	number=PLURAL|gender=MASCULINE|case=DATIVE	
λήξειεν	λήγω	VB	person=PERSON_3|number=SINGULAR|voice=ACTIVE	
ἕζετο	ἕζομαι	VB	person=PERSON_3|number=SINGULAR|mood=INDICATIVE	
δ̓	δε	CONJ	_	
ἐγγὺς	ἐγγὺς	PREP	_	
ὁδοῖο	ὁδός	NN	number=SINGULAR|gender=FEMININE|case=GENITIVE	
φίλον	φίλος	ADJ	number=SINGULAR|gender=NEUTER|case=ACCUSATIVE	
τετιημένη	τετίημαι	VB	number=SINGULAR|tense=PERF|mood=PARTICIPLE|gender=FEMININE|case=NOMINATIVE	
ἦτορ	ἦτορ	NN	number=SINGULAR|gender=NEUTER|case=ACCUSATIVE	
Παρθενίῳ	Παρθένιος	NN	number=SINGULAR|gender=MASCULINE|case=DATIVE	
φρέατι	φρέαρ	NN	number=SINGULAR|gender=NEUTER|case=DATIVE	
ὅθεν	ὅθεν	CONJ	_	
ὑδρεύοντο	ὑδρεύω	VB	person=PERSON_3|number=PLURAL|tense=IMP|mood=INDICATIVE	
πολῖται	πολίτης	NN	number=PLURAL|gender=MASCULINE|case=NOMINATIVE	
ἐν	ἐν	PREP	_	
σκιῇ	σκιά	NN	number=SINGULAR|gender=FEMININE|case=DATIVE	
αὐτὰρ	αὐτὰρ	CONJ	_	
ὕπερθε	ὕπερθε	ADV	_	
πεφύκει	φύω	VB	person=PERSON_3|number=SINGULAR|tense=PLUSQUAMPERFECT|mood=INDICATIVE|voice=ACTIVE	
θάμνος	θάμνος	NN	number=SINGULAR|gender=MASCULINE|case=NOMINATIVE	
ἐλαίης	ἐλαία	NN	number=SINGULAR|gender=FEMININE|case=GENITIVE	
γρηὶ	γραῦς	NN	number=SINGULAR|gender=FEMININE|case=DATIVE	
παλαιγενέι	παλαιγενής	ADJ	number=SINGULAR|case=DATIVE	
ἐναλίγκιος	ἐναλίγκιος	ADJ	number=SINGULAR|gender=MASCULINE|case=NOMINATIVE	
ἥτε	ὅστε	PRON	number=SINGULAR|gender=FEMININE|case=NOMINATIVE	
τόκοιο	τόκος	NN	number=SINGULAR|gender=MASCULINE|case=GENITIVE	
εἴργηται	ἔργω	VB	person=PERSON_3|number=SINGULAR|tense=PR|mood=SUBJUNCTIVE	
δώρων	δῶρον	NN	number=PLURAL|gender=NEUTER|case=GENITIVE	
τε	τε	CONJ	_	
φιλοστεφάνου	φιλοστέφανος	ADJ	number=SINGULAR|gender=FEMININE|case=GENITIVE	
Ἀφροδίτης	Ἀφροδίτη	NN	number=SINGULAR|gender=FEMININE|case=GENITIVE	
οἷαί	οἷος	ADJ	number=PLURAL|gender=FEMININE|case=NOMINATIVE	
τε	τε	CONJ	_	
τροφοί	τροφός	NN	number=PLURAL|gender=FEMININE|case=NOMINATIVE	
εἰσι	εἰμί	VB	person=PERSON_3|number=PLURAL|tense=PR|mood=INDICATIVE|voice=ACTIVE	
θεμιστοπόλων	θεμιστοπόλος	ADJ	number=PLURAL|gender=MASCULINE|case=GENITIVE	
βασιλήων	βασιλεύς	NN	number=PLURAL|gender=MASCULINE|case=GENITIVE	
παίδων	παῖς	NN	number=PLURAL|gender=MASCULINE|case=GENITIVE	
καὶ	καί	CONJ	_	
ταμίαι	ταμία	NN	number=PLURAL|gender=FEMININE|case=NOMINATIVE	
κατὰ	κατά	PREP	_	
δώματα	δῶμα	NN	number=PLURAL|gender=NEUTER|case=ACCUSATIVE	
ἠχήεντα	ἠχήεις	ADJ	number=PLURAL|gender=NEUTER|case=ACCUSATIVE	
ἡ	ὁ	PRON	number=SINGULAR|gender=FEMININE|case=NOMINATIVE	
ὣς	ὣς	CONJ	_	
ἔφαθ̓	φῆμι	VB	person=PERSON_3|number=SINGULAR|tense=IMP|mood=INDICATIVE	
δὴ	δή	ADV	_	
γὰρ	γάρ	ADV	_	
πολὺ	πολὺ	ADV	_	
φέρτεροί	φέρτατος	ADJ	number=PLURAL|gender=MASCULINE|case=NOMINATIVE	
εἰσι	εἰμί	VB	person=PERSON_3|number=PLURAL|tense=PR|mood=INDICATIVE|voice=ACTIVE	
εὖτέ	εὖτε	CONJ	_	
μοι	ἐγώ	PRON	person=PERSON_1|number=SINGULAR|gender=FEMININE|case=DATIVE	
Ἑρμῆς	Ἑρμῆς	NN	number=SINGULAR|gender=MASCULINE|case=NOMINATIVE	
ἦλθ̓	ερχομαι	VB	person=PERSON_3|number=SINGULAR|mood=INDICATIVE|voice=ACTIVE	
ἐριούνιος	ἐριούνης	NN	number=SINGULAR|gender=MASCULINE|case=NOMINATIVE	
ἄγγελος	ἄγγελος	NN	number=SINGULAR|gender=MASCULINE|case=NOMINATIVE	
ὠκὺς	ὠκύς	ADJ	number=SINGULAR|gender=MASCULINE|case=NOMINATIVE	
πὰρ	παρά	PREP	_	
πατέρος	πατήρ	NN	number=SINGULAR|gender=MASCULINE|case=GENITIVE	
Κρονιδαο	Κρονιδης	ADJ	number=SINGULAR|gender=MASCULINE|case=GENITIVE	
καὶ	καί	CONJ	_	
ἄλλων	ἄλλος	PRON	number=PLURAL|gender=MASCULINE|case=GENITIVE	
Οὐρανιώνων	Οὐρανίωνες	NN	number=PLURAL|gender=MASCULINE|case=GENITIVE	
ἐλθεῖν	ἔρχομαι	VB	mood=INFINITIVE|voice=ACTIVE	
ἐξ	ἐκ	PREP	_	
Ἐρέβευς	Ἔρεβος	NN	number=SINGULAR|gender=NEUTER|case=GENITIVE	
ἵνα	ἵνα	CONJ	_	
ὀφθαλμοῖσιν	ὀφθαλμός	NN	number=PLURAL|gender=MASCULINE|case=DATIVE	
ἰδοῦσα	εἶδον	VB	number=SINGULAR|mood=PARTICIPLE|voice=ACTIVE|gender=FEMININE|case=NOMINATIVE	
λήξαις	λήγω	VB	person=PERSON_2|number=SINGULAR|voice=ACTIVE	
ἀθανάτοισι	ἀθάνατος	ADJ	number=PLURAL|gender=MASCULINE|case=DATIVE	
χόλου	χόλος	NN	number=SINGULAR|gender=MASCULINE|case=GENITIVE	
καὶ	καί	CONJ	_	
μήνιος	μῆνις	NN	number=SINGULAR|gender=FEMININE|case=GENITIVE	
αἰνῆς	αἰνός	ADJ	number=SINGULAR|gender=FEMININE|case=GENITIVE	
αὐτίκ̓	αὐτίκα	ADV	_	
ἐγὼν	ἐγώ	PRON	person=PERSON_1|number=SINGULAR|gender=FEMININE|case=NOMINATIVE	
ἀνόρουσ̓	ἀνόρουω	VB	person=PERSON_1|number=SINGULAR|mood=INDICATIVE|voice=ACTIVE	
ὑπὸ	ὑπό	PREP	_	
χάρματος	χάρμα	NN	number=SINGULAR|gender=NEUTER|case=GENITIVE	
τῇ	ὁ	PRON	number=SINGULAR|gender=FEMININE|case=DATIVE	
δὲ	δὲ	CONJ	_	
δέπας	δέπας	NN	number=SINGULAR|gender=NEUTER|case=ACCUSATIVE	
Μετάνειρα	Μετανείρα	NN	number=SINGULAR|gender=FEMININE|case=NOMINATIVE	
δίδου	δίδωμι	VB	person=PERSON_3|number=SINGULAR|tense=IMP|mood=INDICATIVE|voice=ACTIVE	
μελιηδέος	μελιηδής	ADJ	number=SINGULAR|gender=NEUTER|case=GENITIVE	
οἴνου	οἶνον	NN	number=SINGULAR|gender=NEUTER|case=GENITIVE	
πλήσασ̓	πίμπλημι	VB	number=SINGULAR|mood=PARTICIPLE|voice=ACTIVE|gender=FEMININE|case=NOMINATIVE	
οὐδ̓	οὐδε	CONJ	_	
ἀπίθησε	ἀπιθέω	VB	person=PERSON_3|number=SINGULAR|mood=INDICATIVE|voice=ACTIVE	
θεὰ	θεά	NN	number=SINGULAR|gender=FEMININE|case=NOMINATIVE	
Διὸς	Ζεύς	NN	number=SINGULAR|gender=MASCULINE|case=GENITIVE	
ἀγγελιάων	ἀγγελία	NN	number=PLURAL|gender=FEMININE|case=GENITIVE	
αὐτὰρ	αὐτὰρ	CONJ	_	
ὅ	ὁ		number=SINGULAR|gender=MASCULINE|case=NOMINATIVE	
γ̓	γε	ADV	_	
αὐτὸς	αὐτός	PRON	number=SINGULAR|gender=MASCULINE|case=NOMINATIVE	
ῥοιῆς	ῥοιά	NN	number=SINGULAR|gender=FEMININE|case=GENITIVE	
κόκκον	κόκκος	NN	number=SINGULAR|gender=MASCULINE|case=ACCUSATIVE	
ἔδωκε	δίδωμι	VB	person=PERSON_3|number=SINGULAR|mood=INDICATIVE|voice=ACTIVE	
φαγεῖν	ἐσθίω	VB	mood=INFINITIVE|voice=ACTIVE	
μελιηδέα	μελιηδής	ADJ	number=SINGULAR|gender=MASCULINE|case=ACCUSATIVE	
λάθρῃ	λάθρῃ	ADV	_	
ἀμφὶ	ἀμφί	PREP	_	
ἓ	ἕ	PRON	number=SINGULAR|gender=FEMININE|case=ACCUSATIVE	
νωμήσας	νωμάω	VB	number=SINGULAR|mood=PARTICIPLE|voice=ACTIVE|gender=MASCULINE|case=NOMINATIVE	
ἵνα	ἵνα	CONJ	_	
μὴ	μὴ	ADV	_	
μένοι	μένω	VB	person=PERSON_3|number=SINGULAR|tense=PR|voice=ACTIVE	
ἤματα	ἦμαρ	NN	number=PLURAL|gender=NEUTER|case=ACCUSATIVE	
πάντα	πᾶς	ADJ	number=PLURAL|gender=NEUTER|case=ACCUSATIVE	
αὖθι	αὖθι	ADV	_	
παῤ	παρα	PREP	_	
αἰδοίῃ	αἰδοῖος	ADJ	number=SINGULAR|gender=FEMININE|case=DATIVE	
Δημήτερι	Δημήτηρ	NN	number=SINGULAR|gender=FEMININE|case=DATIVE	
κυανοπέπλῳ	κυανόπεπλος	ADJ	number=SINGULAR|gender=FEMININE|case=DATIVE	
ἣ	ὁ	PRON	number=SINGULAR|gender=FEMININE|case=NOMINATIVE	
δ̓	δε	CONJ	_	
ἀνένευσ̓	ἀνανεύω	VB	person=PERSON_3|number=SINGULAR|mood=INDICATIVE|voice=ACTIVE	
ὄλβιος	ὄλβιος	ADJ	number=SINGULAR|gender=MASCULINE|case=NOMINATIVE	
ὃς	ὅς	PRON	number=SINGULAR|gender=MASCULINE|case=NOMINATIVE	
τάδ̓	ὅδε	PRON	number=PLURAL|gender=NEUTER|case=ACCUSATIVE	
ὄπωπεν	ὁράω	VB	person=PERSON_3|number=SINGULAR|tense=PERF|mood=INDICATIVE|voice=ACTIVE	
ἐπιχθονίων	ἐπιχθόνιος	ADJ	number=PLURAL|gender=MASCULINE|case=GENITIVE	
ἀνθρώπων	ἄνθρωπος	NN	number=PLURAL|gender=MASCULINE|case=GENITIVE	
ἐστιν	εἰμί	VB	person=PERSON_3|number=SINGULAR|tense=PR|mood=INDICATIVE|voice=ACTIVE	
τὴν	ὁ	PRON	number=SINGULAR|gender=FEMININE|case=ACCUSATIVE	
δ̓	δε	CONJ	_	
αὖτε	αὖτε	ADV	_	
προσέειπεν	προσεῖπον	VB	person=PERSON_3|number=SINGULAR|mood=INDICATIVE|voice=ACTIVE	
ἐυστέφανος	εὐστέφανος	ADJ	number=SINGULAR|gender=FEMININE|case=NOMINATIVE	
Δημήτηρ	Δημήτηρ	NN	number=SINGULAR|gender=FEMININE|case=NOMINATIVE	
τῇ	τῇ	ADV	_	
δ̓	δε	CONJ	_	
ἔκθοῤ	θρωσκω	VB	person=PERSON_3|number=SINGULAR|mood=INDICATIVE|voice=ACTIVE	
ἄναξ	ἄναξ	NN	number=SINGULAR|gender=MASCULINE|case=NOMINATIVE	
κρατερὸς	κρατερός	ADJ	number=SINGULAR|gender=MASCULINE|case=NOMINATIVE	
Πολυδέγμων	πολυδέγμων	ADJ	number=SINGULAR|gender=MASCULINE|case=NOMINATIVE	
νεῦσε	νεύω	VB	person=PERSON_3|number=SINGULAR|mood=INDICATIVE|voice=ACTIVE	
δέ	δέ	CONJ	_	
οἱ	ἕ	PRON	number=SINGULAR|gender=FEMININE|case=DATIVE	
κούρην	κόρη	NN	number=SINGULAR|gender=FEMININE|case=ACCUSATIVE	
ἔτεος	ἔτος	NN	number=SINGULAR|gender=NEUTER|case=GENITIVE	
περιτελλομένοιο	περιτέλλομαι	VB	number=SINGULAR|mood=PARTICIPLE|gender=NEUTER|case=GENITIVE	
τὴν	ὁ		number=SINGULAR|gender=FEMININE|case=ACCUSATIVE	
τριτάτην	τρίτατος	ADJ	number=SINGULAR|gender=FEMININE|case=ACCUSATIVE	
μὲν	μέν	ADV	_	
μοῖραν	μοῖρα	NN	number=SINGULAR|gender=FEMININE|case=ACCUSATIVE	
ὑπὸ	ὑπό	PREP	_	
ζόφον	ζόφος	NN	number=SINGULAR|gender=MASCULINE|case=ACCUSATIVE	
ἠερόεντα	ἠερόεις	ADJ	number=SINGULAR|gender=MASCULINE|case=ACCUSATIVE	
τὰς	ὁ		number=PLURAL|gender=FEMININE|case=ACCUSATIVE	
δὲ	δὲ	CONJ	_	
δύω	δύο	NRL	_	
παρὰ	παρά	PREP	_	
μητρὶ	μήτηρ	NN	number=SINGULAR|gender=FEMININE|case=DATIVE	
καὶ	καί	CONJ	_	
ἄλλοις	ἄλλος	PRON	number=PLURAL|gender=MASCULINE|case=DATIVE	
ἀθανάτοισιν	ἀθάνατος	ADJ	number=PLURAL|gender=MASCULINE|case=DATIVE	
εἰναι	εἰναι	VB	tense=PR|mood=INFINITIVE|voice=ACTIVE	
εἰναι	εἰναι	VB	tense=PR|mood=INFINITIVE|voice=ACTIVE	
τοῦ	ὁ	PRON	number=SINGULAR|gender=NEUTER|case=GENITIVE	
δ̓	δε	CONJ	_	
οὐ	οὐ	ADV	_	
μειλίσσετο	μειλίσσω	VB	person=PERSON_3|number=SINGULAR|tense=IMP|mood=INDICATIVE	
θυμός	θυμός	NN	number=SINGULAR|gender=MASCULINE|case=NOMINATIVE	
τῇ	ὁ	PRON	number=SINGULAR|gender=FEMININE|case=DATIVE	
δὲ	δὲ	CONJ	_	
φίλην	φίλος	ADJ	number=SINGULAR|gender=FEMININE|case=ACCUSATIVE	
ἔτι	ἔτι	ADV	_	
παῖδα	παῖς	NN	number=SINGULAR|gender=FEMININE|case=ACCUSATIVE	
ἑῇς	ἑός	ADJ	number=PLURAL|gender=FEMININE|case=DATIVE	
μετὰ	μετά	PREP	_	
χερσὶν	χείρ	NN	number=PLURAL|gender=FEMININE|case=DATIVE	
ἐχούσῃ	ἔχω	VB	number=SINGULAR|tense=PR|mood=PARTICIPLE|voice=ACTIVE|gender=FEMININE|case=DATIVE	
α[ἶψα	αἶψα	ADV	_	
δόλον	δόλος	NN	number=SINGULAR|gender=MASCULINE|case=ACCUSATIVE	
θυμός	θυμός	NN	number=SINGULAR|gender=MASCULINE|case=NOMINATIVE	
τιν̓	τις	PRON	number=SINGULAR|gender=NEUTER|case=ACCUSATIVE	
ὀίσατο	οἴομαι	VB	person=PERSON_3|number=SINGULAR|mood=INDICATIVE	
τρέσσε	τρέω	VB	person=PERSON_3|number=SINGULAR|mood=INDICATIVE|voice=ACTIVE	
δ̓	δε	CONJ	_	
ἄῤ	ἄρα	ADV	_	
αἰνῶς	αἰνῶς	ADV	_	
παυομ[ένη	παύω	VB	number=SINGULAR|tense=PR|mood=PARTICIPLE|gender=FEMININE|case=NOMINATIVE	
φιλότητος	φιλότης	NN	number=SINGULAR|gender=FEMININE|case=GENITIVE	
ἄφαρ	ἄφαρ	ADV	_	
δ̓	δε	CONJ	_	
ἐρεείνετο	ἐρεείνω	VB	person=PERSON_3|number=SINGULAR|tense=IMP|mood=INDICATIVE	
μύθῳ	μῦθος	NN	number=SINGULAR|gender=MASCULINE|case=DATIVE	
ὃ	ὁ	PRON	number=SINGULAR|gender=MASCULINE|case=NOMINATIVE	
δὲ	δὲ	CONJ	_	
νόσφιν	νόσφι	PREP	_	
ἧστο	ἧμαι	VB	person=PERSON_3|number=SINGULAR|tense=PLUSQUAMPERFECT|mood=INDICATIVE	
θεῶν	θεὸς	NN	number=PLURAL|gender=MASCULINE|case=GENITIVE	
ἀπάνευθε	ἀπάνευθε	ADV	_	
πολυλλίστῳ	πολύλλιστος	ADJ	number=SINGULAR|gender=MASCULINE|case=DATIVE	
ἐνὶ	ἐν	PREP	_	
νηῷ	ναός	NN	number=SINGULAR|gender=MASCULINE|case=DATIVE	
δέγμενος	δέχομαι	VB	number=SINGULAR|mood=PARTICIPLE|gender=MASCULINE|case=NOMINATIVE	
ἱερὰ	ἱερόν	NN	number=PLURAL|gender=NEUTER|case=ACCUSATIVE	
καλὰ	καλός	ADJ	number=PLURAL|gender=NEUTER|case=ACCUSATIVE	
παρὰ	παρά	PREP	_	
θνητῶν	θνητός	ADJ	number=PLURAL|gender=MASCULINE|case=GENITIVE	
ἀνθρώπων	ἄνθρωπος	NN	number=PLURAL|gender=MASCULINE|case=GENITIVE	
Δήμητερ	Δήμητηρ	NN	number=SINGULAR|gender=FEMININE|case=VOCATIVE	
καλέει	καλέω	VB	person=PERSON_3|number=SINGULAR|tense=PR|mood=INDICATIVE|voice=ACTIVE	
σε	σύ	PRON	person=PERSON_2|number=SINGULAR|case=ACCUSATIVE	
πατὴρ	πατήρ	NN	number=SINGULAR|gender=MASCULINE|case=NOMINATIVE	
Ζεὺς	Ζεύς	NN	number=SINGULAR|gender=MASCULINE|case=NOMINATIVE	
ἄφθιτα	ἄφθιτος	ADJ	number=PLURAL|gender=NEUTER|case=ACCUSATIVE	
εἰδὼς	οἶδα	VB	number=SINGULAR|tense=PERF|mood=PARTICIPLE|voice=ACTIVE|gender=MASCULINE|case=NOMINATIVE	
ἐλθέμεναι	ἔρχομαι	VB	mood=INFINITIVE|voice=ACTIVE	
μετὰ	μετά	PREP	_	
φῦλα	φῦλον	NN	number=PLURAL|gender=NEUTER|case=ACCUSATIVE	
θεῶν	θεὸς	NN	number=PLURAL|gender=MASCULINE|case=GENITIVE	
αἰειγενετάων	αἰειγενετάος	ADJ	number=PLURAL|gender=MASCULINE|case=GENITIVE	
ὣς	ὡς	CONJ	_	
φάτο	φημί	VB	person=PERSON_3|number=SINGULAR|tense=IMP|mood=INDICATIVE	
αἳ	ὁ	PRON	number=PLURAL|gender=FEMININE|case=NOMINATIVE	
δ̓	δε	CONJ	_	
ὥστ̓	ὥστε	CONJ	_	
ἢ	ἤ	CONJ	_	
ἔλαφοι	ἔλαφος	NN	number=PLURAL|gender=FEMININE|case=NOMINATIVE	
ἢ	ἤ	CONJ	_	
πόρτιες	πόρτις	NN	number=PLURAL|gender=FEMININE|case=NOMINATIVE	
εἴαρος	ἔαρ	NN	number=SINGULAR|gender=NEUTER|case=GENITIVE	
ὥρῃ	ὥρα	NN	number=SINGULAR|gender=FEMININE|case=DATIVE	
ἅλλοντ̓	ἅλλομαι	VB	person=PERSON_3|number=PLURAL|tense=PR|mood=INDICATIVE|voice=ACTIVE	
ἂν	ἀνά	PREP	_	
λειμῶνα	λειμών	NN	number=SINGULAR|gender=MASCULINE|case=ACCUSATIVE	
κορεσσάμεναι	κορέννυμι	VB	number=PLURAL|mood=PARTICIPLE|gender=FEMININE|case=NOMINATIVE	
φρένα	φρήν	NN	number=SINGULAR|gender=FEMININE|case=ACCUSATIVE	
φορβῇ	φορβή	NN	number=SINGULAR|gender=FEMININE|case=DATIVE	
ὣς	ὡς	ADV	_	
αἳ	ὁ	PRON	number=PLURAL|gender=FEMININE|case=NOMINATIVE	
ἐπισχόμεναι	ἐπίσχω	VB	number=PLURAL|tense=PR|mood=PARTICIPLE|gender=FEMININE|case=NOMINATIVE	
ἑανῶν	ἑανός	NN	number=PLURAL|gender=MASCULINE|case=GENITIVE	
πτύχας	πτύξ	NN	number=PLURAL|gender=FEMININE|case=ACCUSATIVE	
ἱμεροέντων	ἱμερόεις	ADJ	number=PLURAL|gender=MASCULINE|case=GENITIVE	
ἤιξαν	ἀίσσω	VB	person=PERSON_3|number=PLURAL|mood=INDICATIVE|voice=ACTIVE	
κοίλην	κοῖλος	ADJ	number=SINGULAR|gender=FEMININE|case=ACCUSATIVE	
κατ̓	κατα	PREP	_	
ἀμαξιτόν	ἁμαξιτός	ADJ	number=SINGULAR|gender=FEMININE|case=ACCUSATIVE	
ὣς	ὣς	CONJ	_	
ἔφατ̓	φῆμι	VB	person=PERSON_3|number=SINGULAR|tense=IMP|mood=INDICATIVE|voice=ACTIVE	
γεγήθει	γηθέω	VB	person=PERSON_3|number=SINGULAR|tense=PLUSQUAMPERFECT|mood=INDICATIVE|voice=ACTIVE	
δὲ	δὲ	CONJ	_	
φρένα	φρήν	NN	number=SINGULAR|gender=FEMININE|case=ACCUSATIVE	
μήτηρ	μήτηρ	NN	number=SINGULAR|gender=FEMININE|case=NOMINATIVE	
ὃ	ὁ	PRON	number=SINGULAR|gender=MASCULINE|case=NOMINATIVE	
δ̓	δε	CONJ	_	
ἀέξετο	ἀέξω	VB	person=PERSON_3|number=SINGULAR|tense=IMP|mood=INDICATIVE	
δαίμονι	δαίμων	NN	number=SINGULAR|gender=MASCULINE|case=DATIVE	
ἶσος	ἴσος	ADJ	number=SINGULAR|gender=MASCULINE|case=NOMINATIVE	
οὔ	οὐ	ADV	_	
-τ̓	τε	CONJ	_	
οὖν	οὖν	ADV	_	
σῖτον	σῖτος	NN	number=SINGULAR|gender=MASCULINE|case=ACCUSATIVE	
ἔδων	ἔδω	VB	number=SINGULAR|tense=PR|mood=PARTICIPLE|voice=ACTIVE|gender=MASCULINE|case=NOMINATIVE	
οὐ	οὐ	ADV	_	
θησάμενος	θάω	VB	number=SINGULAR|mood=PARTICIPLE|gender=MASCULINE|case=NOMINATIVE	
γάλα	γάλα	NN	number=SINGULAR|gender=NEUTER|case=ACCUSATIVE	
μητρὸς	μήτηρ	NN	number=SINGULAR|gender=FEMININE|case=GENITIVE	
ἠματίη	ἠμάτιος	ADJ	number=SINGULAR|gender=FEMININE|case=NOMINATIVE	
μὲν	μέν	ADV	_	
γὰρ	γάρ	ADV	_	
καλλιστέφανος	καλλιστέφανος	ADJ	number=SINGULAR|gender=FEMININE|case=NOMINATIVE	
Δημήτηρ	Δημήτηρ	NN	number=SINGULAR|gender=FEMININE|case=NOMINATIVE	
χρίεσκ̓	χρίω	VB	person=PERSON_3|number=SINGULAR|tense=IMP|mood=INDICATIVE|voice=ACTIVE	
ἀμβροσίῃ	ἀμβροσία	NN	number=SINGULAR|gender=FEMININE|case=DATIVE	
ὡσεὶ	ὡσεὶ	CONJ	_	
θεοῦ	θεός	NN	number=SINGULAR|gender=MASCULINE|case=GENITIVE	
ἐκγεγαῶτα	ἐκγίγνομαι	VB	number=SINGULAR|tense=PERF|mood=PARTICIPLE|voice=ACTIVE|gender=MASCULINE|case=ACCUSATIVE	
ἡδὺ	ἡδύς	ADJ	number=SINGULAR|gender=NEUTER|case=ACCUSATIVE	
καταπνείουσα	καταπνέω	VB	number=SINGULAR|tense=PR|mood=PARTICIPLE|voice=ACTIVE|gender=FEMININE|case=NOMINATIVE	
καὶ	καί	CONJ	_	
ἐν	ἐν	PREP	_	
κόλποισιν	κόλπος	NN	number=PLURAL|gender=MASCULINE|case=DATIVE	
ἔχουσα	ἔχω	VB	number=SINGULAR|tense=PR|mood=PARTICIPLE|voice=ACTIVE|gender=FEMININE|case=NOMINATIVE	
φωνῆς	φωνή	NN	number=SINGULAR|gender=FEMININE|case=GENITIVE	
γὰρ	γάρ	ADV	_	
ἤκουσ̓	ἀκούω	VB	person=PERSON_1|number=SINGULAR|mood=INDICATIVE|voice=ACTIVE	
ἀτὰρ	ἀτὰρ	CONJ	_	
οὐκ	οὐ	ADV	_	
ἴδον	εἶδον	VB	person=PERSON_1|number=SINGULAR|mood=INDICATIVE|voice=ACTIVE	
ὀφθαλμοῖσιν	ὀφθαλμός	NN	number=PLURAL|gender=MASCULINE|case=DATIVE	
ὅστις	ὅστις	PRON	number=SINGULAR|gender=MASCULINE|case=NOMINATIVE	
ἔην	εἰμί	VB	person=PERSON_3|number=SINGULAR|tense=IMP|mood=INDICATIVE|voice=ACTIVE	
ἔνθα	ἔνθα	ADV	_	
δὲ	δὲ	CONJ	_	
ναιετάουσι	ναιετάω	VB	person=PERSON_3|number=PLURAL|tense=PR|mood=INDICATIVE|voice=ACTIVE	
παραὶ	παρά	PREP	_	
Διὶ	Ζεύς	NN	number=SINGULAR|gender=MASCULINE|case=DATIVE	
τερπικεραύνῳ	τερπικέραυνος	ADJ	number=SINGULAR|gender=MASCULINE|case=DATIVE	
σεμναί	σεμνός	ADJ	number=PLURAL|gender=FEMININE|case=NOMINATIVE	
τ̓	τε	CONJ	_	
αἰδοῖαι	αἰδοῖος	ADJ	number=PLURAL|gender=FEMININE|case=NOMINATIVE	
τε	τε	CONJ	_	
ὃ	ὁ	PRON	number=SINGULAR|gender=MASCULINE|case=NOMINATIVE	
δ̓	δε	CONJ	_	
ὑπὸ	ὑπό	PREP	_	
ζόφον	ζόφος	NN	number=SINGULAR|gender=MASCULINE|case=ACCUSATIVE	
ἠερόεντα	ἠερόεις	ADJ	number=SINGULAR|gender=MASCULINE|case=ACCUSATIVE	
ἁρπάξας	ἁρπάζω	VB	number=SINGULAR|mood=PARTICIPLE|voice=ACTIVE|gender=MASCULINE|case=NOMINATIVE	
ἵπποισιν	ἵππος	NN	number=PLURAL|gender=MASCULINE|case=DATIVE	
ἄγεν	ἄγω	VB	person=PERSON_3|number=SINGULAR|tense=IMP|mood=INDICATIVE|voice=ACTIVE	
μεγάλα	μεγάλα	ADV	_	
ἰάχουσαν	ἰάχω	VB	number=SINGULAR|tense=PR|mood=PARTICIPLE|voice=ACTIVE|gender=FEMININE|case=ACCUSATIVE	
αἳ	ὁ	PRON	number=PLURAL|gender=FEMININE|case=NOMINATIVE	
μὲν	μέν	ADV	_	
παννύχιαι	παννύχιος	ADJ	number=PLURAL|gender=FEMININE|case=NOMINATIVE	
κυδρὴν	κυδρός	ADJ	number=SINGULAR|gender=FEMININE|case=ACCUSATIVE	
θεὸν	θεός	NN	number=SINGULAR|gender=MASCULINE|case=ACCUSATIVE	
ἱλάσκοντο	ἱλάσκομαι	VB	person=PERSON_3|number=PLURAL|tense=IMP|mood=INDICATIVE	
δείματι	δεῖμα	NN	number=SINGULAR|gender=NEUTER|case=DATIVE	
παλλόμεναι	πάλλω	VB	number=PLURAL|tense=PR|mood=PARTICIPLE|gender=FEMININE|case=NOMINATIVE	
ἅμα	ἅμα	ADV	_	
δ̓	δε	CONJ	_	
ἠοῖ	ἠώς	NN	number=SINGULAR|gender=FEMININE|case=DATIVE	
φαινομένηφιν	φαίνω	VB	number=SINGULAR|tense=PR|mood=PARTICIPLE|gender=FEMININE|case=DATIVE	
εὐρυβίῃ	εὐρυβίας	NN	number=SINGULAR|gender=MASCULINE|case=DATIVE	
Κελεῷ	Κελεός	NN	number=SINGULAR|gender=MASCULINE|case=DATIVE	
νημερτέα	νημερτής	ADJ	number=PLURAL|gender=NEUTER|case=ACCUSATIVE	
μυθήσαντο	μυθέομαι	VB	person=PERSON_3|number=PLURAL|mood=INDICATIVE	
ὡς	ὡς	CONJ	_	
ἐπέτελλε	ἐπιτέλλω	VB	person=PERSON_3|number=SINGULAR|mood=INDICATIVE|voice=ACTIVE	
θεά	θεά	NN	number=SINGULAR|gender=FEMININE|case=NOMINATIVE	
καλλιστέφανος	καλλιστέφανος	ADJ	number=SINGULAR|gender=FEMININE|case=NOMINATIVE	
Δημήτηρ	Δημήτηρ	NN	number=SINGULAR|gender=FEMININE|case=NOMINATIVE	
ἡμεῖς	ἐγώ	PRON	person=PERSON_1|number=PLURAL|gender=FEMININE|case=NOMINATIVE	
μὲν	μέν	ADV	_	
μάλα	μάλα	ADV	_	
πᾶσαι	πᾶς	ADJ	number=PLURAL|gender=FEMININE|case=NOMINATIVE	
ἀν̓	ἀνα	PREP	_	
ἱμερτὸν	ἱμερτός	ADJ	number=SINGULAR|gender=MASCULINE|case=ACCUSATIVE	
λειμῶνα	λειμών	NN	number=SINGULAR|gender=MASCULINE|case=ACCUSATIVE	
Λευκίππη	Λευκίππη	NN	number=SINGULAR|gender=FEMININE|case=NOMINATIVE	
Φαινώ	Φαινώ	NN	number=SINGULAR|gender=FEMININE|case=NOMINATIVE	
τε	τε	CONJ	_	
καὶ	καί	CONJ	_	
Ἠλέκτρη	Ἠλέκτρα	NN	number=SINGULAR|gender=FEMININE|case=NOMINATIVE	
καὶ	καί	CONJ	_	
Ἰάνθη	Ἰάνθη	NN	number=SINGULAR|gender=FEMININE|case=NOMINATIVE	
καὶ	καί	CONJ	_	
Μελίτη	Μελίτη	NN	number=SINGULAR|gender=FEMININE|case=NOMINATIVE	
Ἰάχη	Ἰάχη	NN	number=SINGULAR|gender=FEMININE|case=NOMINATIVE	
τε	τε	CONJ	_	
Ῥόδειά	Ῥόδεια	NN	number=SINGULAR|gender=FEMININE|case=NOMINATIVE	
τε	τε	CONJ	_	
Καλλιρόη	Καλλιρόη	NN	number=SINGULAR|gender=FEMININE|case=NOMINATIVE	
τε	τε	CONJ	_	
Μηλόβοσίς	Μηλόβοσις	NN	number=SINGULAR|gender=FEMININE|case=NOMINATIVE	
τε	τε	CONJ	_	
Τύχη	Τύχη	NN	number=SINGULAR|gender=FEMININE|case=NOMINATIVE	
τε	τε	CONJ	_	
καὶ	καί	CONJ	_	
Ὠκυρόη	Ὠκυρόη	NN	number=SINGULAR|gender=FEMININE|case=NOMINATIVE	
καλυκῶπις	καλυκῶπις	NN	number=SINGULAR|gender=FEMININE|case=NOMINATIVE	
Χρυσηίς	Χρυσηίς	NN	number=SINGULAR|gender=FEMININE|case=NOMINATIVE	
τ̓	τε	CONJ	_	
Ἰάνειρά	Ἰάνειρα	NN	number=SINGULAR|gender=FEMININE|case=NOMINATIVE	
τ̓	τε	CONJ	_	
Ἀκάστη	Ἀκάστη	NN	number=SINGULAR|gender=FEMININE|case=NOMINATIVE	
τ̓	τε	CONJ	_	
Ἀδμήτη	Ἀδμήτη	NN	number=SINGULAR|gender=FEMININE|case=NOMINATIVE	
τε	τε	CONJ	_	
καὶ	καί	CONJ	_	
Ῥοδόπη	Ῥοδόπη	NN	number=SINGULAR|gender=FEMININE|case=NOMINATIVE	
Πλουτώ	Πλουτώ	NN	number=SINGULAR|gender=FEMININE|case=NOMINATIVE	
τε	τε	CONJ	_	
καὶ	καί	CONJ	_	
ἱμερόεσσα	ἱμερόεις	ADJ	number=SINGULAR|gender=FEMININE|case=NOMINATIVE	
Καλυψὼ	Καλυψώ	NN	number=SINGULAR|gender=FEMININE|case=NOMINATIVE	
καὶ	καί	CONJ	_	
Στὺξ	Στύξ	NN	number=SINGULAR|gender=FEMININE|case=NOMINATIVE	
Οὐρανίη	Οὐρανία	NN	number=SINGULAR|gender=FEMININE|case=NOMINATIVE	
τε	τε	CONJ	_	
Γαλαξαύρη	Γαλαξαύρη	NN	number=SINGULAR|gender=FEMININE|case=NOMINATIVE	
τ̓	τε	CONJ	_	
ἐρατεινὴ	ἐρατεινός	ADJ	number=SINGULAR|gender=FEMININE|case=NOMINATIVE	
Παλλάς	Παλλάς	NN	number=SINGULAR|gender=FEMININE|case=NOMINATIVE	
τ̓	τε	CONJ	_	
ἐγρεμάχη	ἐγρεμάχη	ADJ	number=SINGULAR|gender=FEMININE|case=NOMINATIVE	
καὶ	καί	CONJ	_	
Ἄρτεμις	Ἄρτεμις	NN	number=SINGULAR|gender=FEMININE|case=NOMINATIVE	
ἰοχέαιρα	ἰοχέαιρα	NN	number=SINGULAR|gender=FEMININE|case=NOMINATIVE	
παίζομεν	παίζω	VB	person=PERSON_1|number=PLURAL|tense=IMP|mood=INDICATIVE|voice=ACTIVE	
ἠδ̓	ἠδη	CONJ	_	
ἄνθεα	ἄνθος	NN	number=PLURAL|gender=NEUTER|case=ACCUSATIVE	
δρέπομεν	δρέπω	VB	person=PERSON_1|number=PLURAL|tense=IMP|mood=INDICATIVE|voice=ACTIVE	
χείρεσσ̓	χείρ	NN	number=PLURAL|gender=FEMININE|case=DATIVE	
ἐρόεντα	ἐρόεις	ADJ	number=PLURAL|gender=NEUTER|case=ACCUSATIVE	
μίγδα	μίγδα	PREP	_	
κρόκον	κρόκος	NN	number=SINGULAR|gender=MASCULINE|case=ACCUSATIVE	
τ̓	τε	CONJ	_	
ἀγανὸν	ἀγανός	ADJ	number=SINGULAR|gender=MASCULINE|case=ACCUSATIVE	
καὶ	καί	CONJ	_	
ἀγαλλίδας	ἀγαλλίς	NN	number=PLURAL|gender=FEMININE|case=ACCUSATIVE	
ἠδ̓	ἠδη	CONJ	_	
ὑάκινθον	ὑάκινθος	NN	number=SINGULAR|gender=MASCULINE|case=ACCUSATIVE	
καὶ	καί	CONJ	_	
ῥοδέας	ῥοδῆ	NN	number=PLURAL|gender=FEMININE|case=ACCUSATIVE	
κάλυκας	κάλυξ	NN	number=PLURAL|gender=FEMININE|case=ACCUSATIVE	
καὶ	καί	CONJ	_	
λείρια	λείριον	NN	number=PLURAL|gender=NEUTER|case=ACCUSATIVE	
θαῦμα	θαῦμα	NN	number=SINGULAR|gender=NEUTER|case=NOMINATIVE	
ἰδέσθαι	εἶδον	VB	mood=INFINITIVE	
νάρκισσόν	νάρκισσος	NN	number=SINGULAR|gender=MASCULINE|case=ACCUSATIVE	
θ̓	τε	CONJ	_	
ὃν	ὅς	PRON	number=SINGULAR|gender=MASCULINE|case=ACCUSATIVE	
ἔφυσ̓	φυω	VB	person=PERSON_3|number=SINGULAR|mood=INDICATIVE|voice=ACTIVE	
ὥς	ὡς	CONJ	_	
περ	πέρ	ADV	_	
κρόκον	κρόκος	NN	number=SINGULAR|gender=MASCULINE|case=ACCUSATIVE	
εὐρεῖα	εὐρύς	ADJ	number=SINGULAR|gender=FEMININE|case=NOMINATIVE	
χθών	χθών	NN	number=SINGULAR|gender=FEMININE|case=NOMINATIVE	
τοῖς	ὁ	PRON	number=PLURAL|gender=NEUTER|case=DATIVE	
ἐσσυμένως	ἐσσυμένος	ADV	_	
δ̓	δε	CONJ	_	
ἐκέλευσε	κελεύω	VB	person=PERSON_3|number=SINGULAR|mood=INDICATIVE|voice=ACTIVE	
δαΐφρονι	δαίφρων	ADJ	number=SINGULAR|case=DATIVE	
Περσεφονείῃ	Περσεφόνεια	NN	number=SINGULAR|gender=FEMININE|case=DATIVE	
Περσεφόνη	Περσεφόνη	NN	number=SINGULAR|gender=FEMININE|case=NOMINATIVE	
δ̓	δε	CONJ	_	
ἑτέρ[ωθεν	ἑτέρωθεν	ADV	_	
ἐπεὶ	ἐπεί	CONJ	_	
ἴδεν	εἶδον	VB	person=PERSON_3|number=SINGULAR|mood=INDICATIVE|voice=ACTIVE	
ὄμματα	ὄμμα	NN	number=PLURAL|gender=NEUTER|case=ACCUSATIVE	
καλὰ	καλός	ADJ	number=PLURAL|gender=NEUTER|case=ACCUSATIVE	
μητρὸς	μήτηρ	NN	number=SINGULAR|gender=FEMININE|case=GENITIVE	
ἑῆς	ἑός	ADJ	number=SINGULAR|gender=FEMININE|case=GENITIVE	
κατ̓	κατα	ADV	_	
ἄῤ	ἄρα	ADV	_	
ἥ	ὁ	PRON	number=SINGULAR|gender=FEMININE|case=NOMINATIVE	
γ̓	γε	ADV	_	
ὄχεα	ὄχος	NN	number=PLURAL|gender=NEUTER|case=ACCUSATIVE	
προλιποῦσα	προλείπω	VB	number=SINGULAR|mood=PARTICIPLE|voice=ACTIVE|gender=FEMININE|case=NOMINATIVE	
καὶ	καί	CONJ	_	
ἵππους	ἵππος	NN	number=PLURAL|gender=MASCULINE|case=ACCUSATIVE	
ἆλτο	ἅλλομαι	VB	person=PERSON_3|number=SINGULAR|mood=INDICATIVE	
θέει[ν	θέω	VB	tense=PR|mood=INFINITIVE|voice=ACTIVE	
δειρῇ	δειρή	NN	number=SINGULAR|gender=FEMININE|case=DATIVE	
δέ	δέ	CONJ	_	
οἱ	ἕ	PRON	number=SINGULAR|gender=FEMININE|case=DATIVE	
ἔμπεσε	ἐμπίτνω	VB	person=PERSON_3|number=SINGULAR|mood=INDICATIVE|voice=ACTIVE	
ἀμφιχυθεῖσα	ἀμφιχέω	VB	number=SINGULAR|mood=PARTICIPLE|voice=PASSIVE|gender=FEMININE|case=NOMINATIVE	
πρόφρονες	πρόφρων	ADJ	number=PLURAL|gender=FEMININE|case=VOCATIVE	
ἀντ̓	ἄντα	PREP	_	
ᾠδῆς	ἀοιδή	NN	number=SINGULAR|gender=FEMININE|case=GENITIVE	
βίοτον	βίοτος	NN	number=SINGULAR|gender=MASCULINE|case=ACCUSATIVE	
θυμήρἐ	θυμηρής	ADJ	number=SINGULAR|gender=MASCULINE|case=NOMINATIVE	
ὄπαζε	ὀπάζω	VB	person=PERSON_2|number=SINGULAR|tense=PR|mood=IMPERATIVE|voice=ACTIVE	
τοιγὰρ	τοιγάρ	ADV	_	
ἐγώ	ἐγώ	PRON	person=PERSON_1|number=SINGULAR|gender=FEMININE|case=NOMINATIVE	
τοι	σύ	PRON	person=PERSON_2|number=SINGULAR|case=DATIVE	
μῆτερ	μήτηρ	NN	number=SINGULAR|gender=FEMININE|case=VOCATIVE	
ἐρέω	ἐρῶ	VB	person=PERSON_1|number=SINGULAR|tense=FUTURE|mood=INDICATIVE|voice=ACTIVE	
νημερτέα	νημερτής	ADJ	number=PLURAL|gender=NEUTER|case=ACCUSATIVE	
πάντα	πᾶς	ADJ	number=PLURAL|gender=NEUTER|case=ACCUSATIVE	
τὴν	ὁ	PRON	number=SINGULAR|gender=FEMININE|case=ACCUSATIVE	
δ̓	δε	CONJ	_	
Ὑπεριονίδης	Ὑπεριονίδης	NN	number=SINGULAR|gender=MASCULINE|case=NOMINATIVE	
ἠμείβετο	ἀμείβω	VB	person=PERSON_3|number=SINGULAR|tense=IMP|mood=INDICATIVE	
μύθῳ	μῦθος	NN	number=SINGULAR|gender=MASCULINE|case=DATIVE	
ὁππότε	ὁππότε	CONJ	_	
δ̓	δε	CONJ	_	
ἄνθεσι	ἄνθος	NN	number=PLURAL|gender=NEUTER|case=DATIVE	
γαῖ̓	γαῖα	NN	number=SINGULAR|gender=FEMININE|case=NOMINATIVE	
εὐώδε[σιν	εὐώδης	ADJ	number=PLURAL|gender=NEUTER|case=DATIVE	
εἰαρινο[ῖσι	ἐαρινός	ADJ	number=PLURAL|gender=NEUTER|case=DATIVE	
παντοδαποῖς	παντοδαπός	ADJ	number=PLURAL|gender=NEUTER|case=DATIVE	
θάλλῃ	θάλλω	VB	person=PERSON_3|number=SINGULAR|tense=PR|mood=SUBJUNCTIVE|voice=ACTIVE	
τόθ̓	τότε	ADV	_	
ὑπὸ	ὑπό	PREP	_	
ζόφου	ζόφος	NN	number=SINGULAR|gender=MASCULINE|case=GENITIVE	
ἠερόεντος	ἠερόεις	ADJ	number=SINGULAR|gender=MASCULINE|case=GENITIVE	
αὖτις	αὖθις	ADV	_	
ἄνει	ἄνειμι	VB	person=PERSON_2|number=SINGULAR|tense=PR|mood=INDICATIVE|voice=ACTIVE	
μέγα	μέγας	ADJ	number=SINGULAR|gender=NEUTER|case=ACCUSATIVE	
θαῦμα	θαῦμα	NN	number=SINGULAR|gender=NEUTER|case=ACCUSATIVE	
θεοῖς	θεός	NN	number=PLURAL|gender=MASCULINE|case=DATIVE	
θνητοῖς	θνητός	ADJ	number=PLURAL|gender=MASCULINE|case=DATIVE	
τ̓	τε	CONJ	_	
ἀνθρώποις	ἄνθρωπος	NN	number=PLURAL|gender=MASCULINE|case=DATIVE	
θεοῖσι	θεός	NN	number=PLURAL|gender=MASCULINE|case=DATIVE	
γὰρ	γάρ	ADV	_	
ἄντα	ἄντα	ADV	_	
ἐῴκει	ἔοικα	VB	person=PERSON_3|number=SINGULAR|tense=PLUSQUAMPERFECT|mood=INDICATIVE|voice=ACTIVE	
οὐδέ	οὐδέ	CONJ	_	
τις	τις	PRON	number=SINGULAR|gender=MASCULINE|case=NOMINATIVE	
ἄλλος	ἄλλος	PRON	number=SINGULAR|gender=MASCULINE|case=NOMINATIVE	
αἴτιος	αἴτιος	ADJ	number=SINGULAR|gender=MASCULINE|case=NOMINATIVE	
ἀθανάτων	ἀθάνατος	ADJ	number=PLURAL|gender=MASCULINE|case=GENITIVE	
εἰ	εἰ	CONJ	_	
μὴ	μὴ	ADV	_	
νεφεληγερέτα	νεφεληγερέτα	NN	number=SINGULAR|gender=MASCULINE|case=NOMINATIVE	
Ζεύς	Ζεύς	NN	number=SINGULAR|gender=MASCULINE|case=NOMINATIVE	
ὅς	ὅς	PRON	number=SINGULAR|gender=MASCULINE|case=NOMINATIVE	
μιν	μιν	PRON	person=PERSON_3|number=SINGULAR|gender=FEMININE|case=ACCUSATIVE	
ἔδωκ̓	δίδωμι	VB	person=PERSON_3|number=SINGULAR|mood=INDICATIVE|voice=ACTIVE	
Ἀίδῃ	Ἅιδης	NN	number=SINGULAR|case=DATIVE	
θαλερὴν	θαλερός	ADJ	number=SINGULAR|gender=FEMININE|case=ACCUSATIVE	
κεκλῆσθαι	καλέω	VB	tense=PERF|mood=INFINITIVE	
ἄκοιτιν	ἄκοιτις	NN	number=SINGULAR|gender=FEMININE|case=ACCUSATIVE	
αὐτοκασιγνήτῳ	αὐτοκασίγνητος	NN	number=SINGULAR|gender=MASCULINE|case=DATIVE	
ἐστι	εἰμί	VB	person=PERSON_3|number=SINGULAR|tense=PR|mood=INDICATIVE|voice=ACTIVE	
ἐστι	εἰμί	VB	person=PERSON_3|number=SINGULAR|tense=PR|mood=INDICATIVE|voice=ACTIVE	
ἐκ	ἐκ	PREP	_	
τοῦ	ὁ	PRON	number=SINGULAR|gender=NEUTER|case=GENITIVE	
οἱ	ἕ	PRON	number=SINGULAR|gender=FEMININE|case=DATIVE	
πρόπολος	πρόπολος	ADJ	number=SINGULAR|gender=FEMININE|case=NOMINATIVE	
καὶ	καί	CONJ	_	
ὀπάων	ὀπάων	NN	number=SINGULAR|gender=MASCULINE|case=NOMINATIVE	
ἔπλετ̓	πέλω	VB	person=PERSON_3|number=SINGULAR|mood=INDICATIVE	
ἄνασσα	ἄνασσα	NN	number=SINGULAR|gender=FEMININE|case=NOMINATIVE	
τάων	ὁ	PRON	number=PLURAL|gender=FEMININE|case=GENITIVE	
οὐκ	οὐ	ADV	_	
ἄν	ἄν	ADV	_	
τίς	τις	PRON	number=SINGULAR|gender=MASCULINE|case=NOMINATIVE	
σε	σύ	PRON	person=PERSON_2|number=SINGULAR|case=ACCUSATIVE	
κατὰ	κατά	PREP	_	
πρώτιστον	πρώτιστος	ADJ	number=SINGULAR|gender=FEMININE|case=ACCUSATIVE	
ὀπωπὴν	ὀπωπή	NN	number=SINGULAR|gender=FEMININE|case=ACCUSATIVE	
εἶδος	εἶδος	NN	number=SINGULAR|gender=NEUTER|case=ACCUSATIVE	
ἀτιμήσασα	ἀτιμάω	VB	number=SINGULAR|mood=PARTICIPLE|voice=ACTIVE|gender=FEMININE|case=NOMINATIVE	
δόμων	δόμος	NN	number=PLURAL|gender=MASCULINE|case=GENITIVE	
ἀπονοσφίσσειεν	ἀπονοσφίζω	VB	person=PERSON_3|number=SINGULAR|voice=ACTIVE	
ἀλλά	ἀλλά	CONJ	_	
σε	σύ	PRON	person=PERSON_2|number=SINGULAR|case=ACCUSATIVE	
δέξονται	δείκνυμι	VB	person=PERSON_3|number=PLURAL|tense=FUTURE|mood=INDICATIVE	
ὣς	ὣς	CONJ	_	
μὲν	μέν	ADV	_	
γάρ	γάρ	ADV	_	
κεν	ἄν	ADV	_	
ἐοῦσα	εἰμί	VB	number=SINGULAR|tense=PR|mood=PARTICIPLE|voice=ACTIVE|gender=FEMININE|case=NOMINATIVE	
π[αρὰ	παρά	PREP	_	
στυγεροῦ	στυγερός	ADJ	number=SINGULAR|gender=MASCULINE|case=GENITIVE	
Ἀίδαο	Ἅιδης	NN	number=SINGULAR|gender=MASCULINE|case=GENITIVE	
καὶ	καί	CONJ	_	
παῤ	παρα	PREP	_	
ἐμοὶ	ἐγώ	PRON	person=PERSON_1|number=SINGULAR|gender=FEMININE|case=DATIVE	
καὶ	καί	CONJ	_	
πατρὶ	πατήρ	NN	number=SINGULAR|gender=MASCULINE|case=DATIVE	
κελ[αινεφέϊ	κελαινεφής	ADJ	number=SINGULAR|case=DATIVE	
Κρονίωνι	Κρονίων	NN	number=SINGULAR|gender=MASCULINE|case=DATIVE	
ναιετάοις	ναιετάω	VB	person=PERSON_2|number=SINGULAR|tense=PR|voice=ACTIVE	
πάντεσσι	πᾶς	ADJ	number=PLURAL|gender=MASCULINE|case=DATIVE	
τετιμ[ένη	τίω	VB	number=SINGULAR|tense=PERF|mood=PARTICIPLE|gender=FEMININE|case=NOMINATIVE	
ἀθανάτοι]σιν	ἀθάνατος	ADJ	number=PLURAL|gender=MASCULINE|case=DATIVE	
ἀλλ̓	ἀλλα	CONJ	_	
ἄγε	ἄγω	VB	person=PERSON_2|number=SINGULAR|tense=PR|mood=IMPERATIVE|voice=ACTIVE	
μοι	ἐγώ	PRON	person=PERSON_1|number=SINGULAR|gender=FEMININE|case=DATIVE	
νηόν	ναός	NN	number=SINGULAR|gender=MASCULINE|case=ACCUSATIVE	
τε	τε	CONJ	_	
μέγαν	μέγας	ADJ	number=SINGULAR|gender=MASCULINE|case=ACCUSATIVE	
καὶ	καί	CONJ	_	
βωμὸν	βωμός	NN	number=SINGULAR|gender=MASCULINE|case=ACCUSATIVE	
ὑπ̓	ὑπο	PREP	_	
αὐτῷ	αὐτός	PRON	number=SINGULAR|gender=MASCULINE|case=DATIVE	
τευχόντων	τεύχω	VB	person=PERSON_3|number=PLURAL|tense=PR|mood=IMPERATIVE|voice=ACTIVE	
πᾶς	πᾶς	ADJ	number=SINGULAR|gender=MASCULINE|case=NOMINATIVE	
δῆμος	δῆμος	NN	number=SINGULAR|gender=MASCULINE|case=NOMINATIVE	
ὑπαὶ	ὑπό	PREP	_	
πόλιν	πόλις	NN	number=SINGULAR|gender=FEMININE|case=ACCUSATIVE	
αἰπύ	αἰπύς	ADJ	number=SINGULAR|gender=NEUTER|case=ACCUSATIVE	
τε	τε	CONJ	_	
τεῖχος	τεῖχος	NN	number=SINGULAR|gender=NEUTER|case=ACCUSATIVE	
Καλλιχόρου	Καλλίχορον	NN	number=SINGULAR|gender=NEUTER|case=GENITIVE	
καθύπερθεν	καθύπερθε	ADV	_	
ἐπὶ	ἐπί	PREP	_	
προὔχοντι	προέχω	VB	number=SINGULAR|tense=PR|mood=PARTICIPLE|voice=ACTIVE|gender=MASCULINE|case=DATIVE	
κολωνῷ	κολωνός	NN	number=SINGULAR|gender=MASCULINE|case=DATIVE	
ἀλλὰ	ἀλλὰ	CONJ	_	
θεῶν	θεὸς	NN	number=PLURAL|gender=MASCULINE|case=GENITIVE	
μὲν	μέν	ADV	_	
δῶρα	δῶρον	NN	number=PLURAL|gender=NEUTER|case=ACCUSATIVE	
καὶ	καὶ	ADV	_	
ἀχνύμενοί	ἀχεύω	VB	number=PLURAL|tense=PR|mood=PARTICIPLE|voice=PASSIVE|gender=MASCULINE|case=NOMINATIVE	
περ	πέρ	ADV	_	
ἀνάγκῃ	ἀνάγκη	NN	number=SINGULAR|gender=FEMININE|case=DATIVE	
τέτλαμεν	τλάω	VB	person=PERSON_1|number=PLURAL|tense=PERF|mood=INDICATIVE|voice=ACTIVE	
ἄνθρωποι	ἄνθρωπος	NN	number=PLURAL|gender=MASCULINE|case=NOMINATIVE	
ὃ	ὁ	PRON	number=SINGULAR|gender=MASCULINE|case=NOMINATIVE	
δ̓	δε	CONJ	_	
ἀέξετο	ἀέξω	VB	person=PERSON_3|number=SINGULAR|tense=IMP|mood=INDICATIVE	
δαίμονι	δαίμων	NN	number=SINGULAR|gender=MASCULINE|case=DATIVE	
ἶσος	ἴσος	ADJ	number=SINGULAR|gender=MASCULINE|case=NOMINATIVE	
ἐπί	ἐπί	PREP	_	
τοι	τοι	ADV	_	
πρέπει	πρέπω	VB	person=PERSON_3|number=SINGULAR|tense=PR|mood=INDICATIVE|voice=ACTIVE	
ὄμμασιν	ὄμμα	NN	number=PLURAL|gender=NEUTER|case=DATIVE	
αἰδὼς	αἰδώς	NN	number=SINGULAR|gender=FEMININE|case=NOMINATIVE	
καὶ	καί	CONJ	_	
χάρις	χάρις	NN	number=SINGULAR|gender=FEMININE|case=NOMINATIVE	
ὡς	ὡς	CONJ	_	
εἴ	εἰ	CONJ	_	
πέρ	πέρ	ADV	_	
τε	τε	ADV	_	
θεμιστοπόλων	θεμιστοπόλος	ADJ	number=PLURAL|gender=MASCULINE|case=GENITIVE	
βασιλήων	βασιλεύς	NN	number=PLURAL|gender=MASCULINE|case=GENITIVE	
ἀλλά	ἀλλά	CONJ	_	
σὺ	σύ	PRON	person=PERSON_2|number=SINGULAR|case=NOMINATIVE	
γὰρ	γάρ	ADV	_	
δὴ	δή	ADV	_	
πᾶσαν	πᾶς	ADJ	number=SINGULAR|gender=FEMININE|case=ACCUSATIVE	
ἐπὶ	ἐπί	PREP	_	
χθόνα	χθών	NN	number=SINGULAR|gender=FEMININE|case=ACCUSATIVE	
καὶ	καί	CONJ	_	
κατὰ	κατά	PREP	_	
πόντον	πόντος	NN	number=SINGULAR|gender=MASCULINE|case=ACCUSATIVE	
αἰθέρος	αἰθήρ	NN	number=SINGULAR|gender=MASCULINE|case=GENITIVE	
ἐκ	ἐκ	PREP	_	
δίης	δῖος	ADJ	number=SINGULAR|gender=FEMININE|case=GENITIVE	
καταδέρκεαι	καταδέρκομαι	VB	person=PERSON_2|number=SINGULAR|tense=PR|mood=INDICATIVE	
ἀκτίνεσσι	ἀκτίς	NN	number=PLURAL|gender=FEMININE|case=DATIVE	
νημερτέως	νημερτής	ADJ	_	
μοι	ἐγώ	PRON	person=PERSON_1|number=SINGULAR|gender=FEMININE|case=DATIVE	
ἔνισπε	ἐνέπω	VB	person=PERSON_2|number=SINGULAR|mood=IMPERATIVE|voice=ACTIVE	
φίλον	φίλος	ADJ	number=SINGULAR|gender=NEUTER|case=VOCATIVE	
τέκος	τέκος	NN	number=SINGULAR|gender=NEUTER|case=VOCATIVE	
εἴ	εἰ	CONJ	_	
που	πού	ADV	_	
ὄπωπας	ὁράω	VB	person=PERSON_2|number=SINGULAR|tense=PERF|mood=INDICATIVE|voice=ACTIVE	
ὅστις	ὅστις	PRON	number=SINGULAR|gender=MASCULINE|case=NOMINATIVE	
νόσφιν	νόσφι	PREP	_	
ἐμεῖο	ἐγώ	PRON	person=PERSON_1|number=SINGULAR|gender=FEMININE|case=GENITIVE	
λαβὼν	λαμβάνω	VB	number=SINGULAR|mood=PARTICIPLE|voice=ACTIVE|gender=MASCULINE|case=NOMINATIVE	
ἀέκουσαν	ἀέκων	ADJ	number=SINGULAR|gender=FEMININE|case=ACCUSATIVE	
ἀνάγκῃ	ἀνάγκη	NN	number=SINGULAR|gender=FEMININE|case=DATIVE	
οἴχεται	οἴχομαι	VB	person=PERSON_3|number=SINGULAR|tense=PR|mood=INDICATIVE	
ἠὲ	ἤ	CONJ	_	
θεῶν	θεὸς	NN	number=PLURAL|gender=MASCULINE|case=GENITIVE	
ἢ	ἤ	CONJ	_	
καὶ	καὶ	ADV	_	
θνητῶν	θνητός	ADJ	number=PLURAL|gender=MASCULINE|case=GENITIVE	
ἀνθρώπων	ἄνθρωπος	NN	number=PLURAL|gender=MASCULINE|case=GENITIVE	
ἠμὲν	ἠμέν	CONJ	_	
Τριπτολέμου	Τριπτόλεμος	NN	number=SINGULAR|gender=MASCULINE|case=GENITIVE	
πυκιμήδεος	πυκιμηδής	ADJ	number=SINGULAR|gender=MASCULINE|case=GENITIVE	
ἠδὲ	ἠδέ	CONJ	_	
Διόκλου	Διόκλος	NN	number=SINGULAR|gender=MASCULINE|case=GENITIVE	
ἠδὲ	ἠδέ	CONJ	_	
Πολυξείνου	Πολύξεινος	NN	number=SINGULAR|gender=MASCULINE|case=GENITIVE	
καὶ	καί	CONJ	_	
ἀμύμονος	ἀμύμων	ADJ	number=SINGULAR|case=GENITIVE	
Εὐμόλποιο	Εὔμολπος	NN	number=SINGULAR|gender=MASCULINE|case=GENITIVE	
καὶ	καί	CONJ	_	
Δολίχου	Δολίχος	NN	number=SINGULAR|gender=MASCULINE|case=GENITIVE	
καὶ	καί	CONJ	_	
πατρὸς	πατήρ	NN	number=SINGULAR|gender=MASCULINE|case=GENITIVE	
ἀγήνορος	ἀγήνωρ	NN	number=SINGULAR|gender=MASCULINE|case=GENITIVE	
ἡμετέροιο	ἡμέτερος	ADJ	number=SINGULAR|gender=MASCULINE|case=GENITIVE	
τῶν	ὁ		number=PLURAL|gender=MASCULINE|case=GENITIVE	
πάντων	πᾶς	ADJ	number=PLURAL|gender=MASCULINE|case=GENITIVE	
ἄλοχοι	ἄλοχος	NN	number=PLURAL|gender=FEMININE|case=NOMINATIVE	
κατὰ	κατά	PREP	_	
δώματα	δῶμα	NN	number=PLURAL|gender=NEUTER|case=ACCUSATIVE	
πορσαίνουσι	πορσύνω	VB	person=PERSON_3|number=PLURAL|tense=PR|mood=INDICATIVE|voice=ACTIVE	
ἐπὶ	ἐπί	PREP	_	
γὰρ	γάρ	ADV	_	
ζυγὸς	ζυγός	NN	number=SINGULAR|gender=MASCULINE|case=NOMINATIVE	
αὐχένι	αὐχήν	NN	number=SINGULAR|gender=MASCULINE|case=DATIVE	
κεῖται	κεῖμαι	VB	person=PERSON_3|number=SINGULAR|tense=PR|mood=INDICATIVE	
τῆς	ὁ	PRON	number=SINGULAR|gender=FEMININE|case=GENITIVE	
δ̓	δε	CONJ	_	
ἄιε	ἀίω	VB	person=PERSON_3|number=SINGULAR|tense=IMP|mood=INDICATIVE|voice=ACTIVE	
δῖα	δῖος	ADJ	number=SINGULAR|gender=FEMININE|case=NOMINATIVE	
θεάων	θεά	NN	number=PLURAL|gender=FEMININE|case=GENITIVE	
ἀγρόμεναι	ἀγείρω	VB	number=PLURAL|mood=PARTICIPLE|gender=FEMININE|case=NOMINATIVE	
δέ	δέ	CONJ	_	
μιν	μιν	PRON	person=PERSON_3|number=SINGULAR|gender=MASCULINE|case=ACCUSATIVE	
ἀμφὶς	ἀμφίς	ADV	_	
ἐλούεον	λούω	VB	person=PERSON_3|number=PLURAL|tense=IMP|mood=INDICATIVE|voice=ACTIVE	
ἀσπαίροντα	ἀσπαίρω	VB	number=SINGULAR|tense=PR|mood=PARTICIPLE|voice=ACTIVE|gender=MASCULINE|case=ACCUSATIVE	
ἀμφαγαπαζόμεναι	ἀμφαγαπάζω	VB	number=PLURAL|tense=PR|mood=PARTICIPLE|gender=FEMININE|case=NOMINATIVE	
ὣς	ὣς	CONJ	_	
φάτο	φημί	VB	person=PERSON_3|number=SINGULAR|mood=INDICATIVE	
πολλὸν	πολύς	ADJ	number=SINGULAR|gender=NEUTER|case=ACCUSATIVE	
δὲ	δὲ	CONJ	_	
κρῖ	κρῖ	ADJ	number=SINGULAR|gender=NEUTER|case=NOMINATIVE	
λευκὸν	λευκόν	NN	number=SINGULAR|gender=NEUTER|case=NOMINATIVE	
ἐτώσιον	ἐτώσιος	ADJ	number=SINGULAR|gender=NEUTER|case=ACCUSATIVE	
ἔμπεσε	ἐμπίτνω	VB	person=PERSON_3|number=SINGULAR|mood=INDICATIVE|voice=ACTIVE	
γαίῃ	γαῖα	NN	number=SINGULAR|gender=FEMININE|case=DATIVE	
τέτμε	τέτμον	VB	person=PERSON_3|number=SINGULAR|mood=INDICATIVE|voice=ACTIVE	
δὲ	δὲ	CONJ	_	
τόν	ὁ		number=SINGULAR|gender=MASCULINE|case=ACCUSATIVE	
γε	γε	ADV	_	
ἄνακτα	ἄναξ	NN	number=SINGULAR|gender=MASCULINE|case=ACCUSATIVE	
δόμων	δόμος	NN	number=PLURAL|gender=MASCULINE|case=GENITIVE	
ἔντοσθεν	ἔντοσθε	ADV	_	
ἐόντα	εἰμί	VB	number=SINGULAR|tense=PR|mood=PARTICIPLE|voice=ACTIVE|gender=MASCULINE|case=ACCUSATIVE	
ἥμενον	ἧμαι	VB	number=SINGULAR|tense=PERF|mood=PARTICIPLE|gender=MASCULINE|case=ACCUSATIVE	
ἐν	ἐν	PREP	_	
λεχέεσσι	λέχος	NN	number=PLURAL|gender=NEUTER|case=DATIVE	
σὺν	σύν	PREP	_	
αἰδοίῃ	αἰδοῖος	ADJ	number=SINGULAR|gender=FEMININE|case=DATIVE	
παρακοίτι	παράκοιτις	NN	number=SINGULAR|gender=FEMININE|case=DATIVE	
πόλλ̓	πόλλα	ADV	_	
ἀεκαζομένῃ	ἀεκαζόμενος	ADJ	number=SINGULAR|gender=FEMININE|case=DATIVE	
μητρὸς	μήτηρ	NN	number=SINGULAR|gender=FEMININE|case=GENITIVE	
πόθῳ	πόθος	NN	number=SINGULAR|gender=MASCULINE|case=DATIVE	
ἀλλ̓	ἀλλα	CONJ	_	
ὑμῖν	σύ	PRON	person=PERSON_2|number=PLURAL|case=DATIVE	
μὲν	μέν	ADV	_	
πάντες	πᾶς	ADJ	number=PLURAL|gender=MASCULINE|case=NOMINATIVE	
Ὀλύμπια	Ὀλύμπιος	ADJ	number=PLURAL|gender=NEUTER|case=ACCUSATIVE	
δώματ̓	δῶμα	NN	number=PLURAL|gender=NEUTER|case=ACCUSATIVE	
ἔχοντες	ἔχω	VB	number=PLURAL|tense=PR|mood=PARTICIPLE|voice=ACTIVE|gender=MASCULINE|case=NOMINATIVE	
δοῖεν	δίδωμι	VB	person=PERSON_3|number=PLURAL|voice=ACTIVE	
κουριδίους	κουρίδιος	ADJ	number=PLURAL|gender=MASCULINE|case=ACCUSATIVE	
ἄνδρας	ἀνήρ	NN	number=PLURAL|gender=MASCULINE|case=ACCUSATIVE	
καὶ	καί	CONJ	_	
τέκνα	τέκνον	NN	number=PLURAL|gender=NEUTER|case=ACCUSATIVE	
τεκέσθαι	τίκτω	VB	mood=INFINITIVE	
ὡς	ὡς	CONJ	_	
ἐθέλουσι	ἐθέλω	VB	person=PERSON_3|number=PLURAL|tense=PR|mood=INDICATIVE|voice=ACTIVE	
τοκῆες	τοκεύς	NN	number=PLURAL|gender=MASCULINE|case=NOMINATIVE	
αἳ	ὁ	PRON	number=PLURAL|gender=FEMININE|case=NOMINATIVE	
δὲ	δὲ	CONJ	_	
πὰρ	παρά	PREP	_	
αὐτὴν	αὐτός	PRON	number=SINGULAR|gender=FEMININE|case=ACCUSATIVE	
ἔδραμον	τρέχω	VB	person=PERSON_3|number=PLURAL|mood=INDICATIVE|voice=ACTIVE	
αὐτὰρ	αὐτὰρ	CONJ	_	
ἔπειτα	ἔπειτα	ADV	_	
φίλου	φίλος	ADJ	number=SINGULAR|gender=MASCULINE|case=GENITIVE	
πρὸς	πρός	PREP	_	
δώματα	δῶμα	NN	number=PLURAL|gender=NEUTER|case=ACCUSATIVE	
πατρὸς	πατήρ	NN	number=SINGULAR|gender=MASCULINE|case=GENITIVE	
ἡγεῦνθ̓	ἡγέομαι	VB	person=PERSON_3|number=PLURAL|tense=IMP|mood=INDICATIVE	
κὦζ̓	ὄζω	VB	person=PERSON_3|number=SINGULAR|tense=IMP|mood=INDICATIVE|voice=ACTIVE	
ἥδιστ̓	ἡδύς	ADJ	number=SINGULAR|gender=FEMININE|case=DATIVE	
ὀδμή	ὀσμή	NN	number=SINGULAR|gender=FEMININE|case=NOMINATIVE	
πᾶς	πᾶς	ADJ	number=SINGULAR|gender=MASCULINE|case=NOMINATIVE	
τ̓	τε	CONJ	_	
οὐρανὸς	οὐρανός	NN	number=SINGULAR|gender=MASCULINE|case=NOMINATIVE	
εὐρὺς	εὐρύς	ADJ	number=SINGULAR|gender=MASCULINE|case=NOMINATIVE	
ὕπερθεν	ὕπερθεν	ADV	_	
γαῖά	γαῖα	NN	number=SINGULAR|gender=FEMININE|case=NOMINATIVE	
τε	τε	CONJ	_	
πᾶσ̓	πᾶσ	ADJ	number=SINGULAR|gender=FEMININE|case=NOMINATIVE	
ἐγελάσσε	γελάω	VB	person=PERSON_3|number=SINGULAR|mood=INDICATIVE|voice=ACTIVE	
καὶ	καί	CONJ	_	
ἁλμυρὸν	ἁλμυρός	ADJ	number=SINGULAR|gender=NEUTER|case=NOMINATIVE	
οἶδμα	οἶδμα	NN	number=SINGULAR|gender=NEUTER|case=NOMINATIVE	
θαλάσσης	θάλασσα	NN	number=SINGULAR|gender=FEMININE|case=GENITIVE	
εἰ	εἰ	CONJ	_	
τόν	ὁ	PRON	number=SINGULAR|gender=MASCULINE|case=ACCUSATIVE	
γε	γε	ADV	_	
θρέψαιο	τρέφω	VB	person=PERSON_2|number=SINGULAR	
καὶ	καί	CONJ	_	
ἥβης	ἥβη	NN	number=SINGULAR|gender=FEMININE|case=GENITIVE	
μέτρον	μέτρον	NN	number=SINGULAR|gender=NEUTER|case=ACCUSATIVE	
ἵκοιτο	ἱκνέομαι	VB	person=PERSON_3|number=SINGULAR	
ῥεῖά	ῥεῖα	ADV	_	
κέ	ἄν	ADV	_	
τίς	τις	PRON	number=SINGULAR|gender=FEMININE|case=NOMINATIVE	
σε	σύ	PRON	person=PERSON_2|number=SINGULAR|case=ACCUSATIVE	
ἰδοῦσα	εἶδον	VB	number=SINGULAR|mood=PARTICIPLE|voice=ACTIVE|gender=FEMININE|case=NOMINATIVE	
γυναικῶν	γυνή	NN	number=PLURAL|gender=FEMININE|case=GENITIVE	
θηλυτεράων	θῆλυς	ADJ	number=PLURAL|gender=FEMININE|case=GENITIVE	
ζηλώσαι	ζηλόω	VB	person=PERSON_3|number=SINGULAR|voice=ACTIVE	
σε	σύ	PRON	person=PERSON_2|number=SINGULAR|case=ACCUSATIVE	
οἶδα	οἶδα	VB	person=PERSON_1|number=SINGULAR|tense=PERF|mood=INDICATIVE|voice=ACTIVE	
γὰρ	γάρ	ADV	_	
ἀντίτομον	ἀντίτομος	ADJ	number=SINGULAR|gender=NEUTER|case=ACCUSATIVE	
μέγα	μέγας	ADJ	number=SINGULAR|gender=NEUTER|case=ACCUSATIVE	
φέρτερον	φέρτατος	ADJ	number=SINGULAR|gender=NEUTER|case=ACCUSATIVE	
ὑλοτόμοιο	ὑλοτόμος	ADJ	number=SINGULAR|gender=MASCULINE|case=GENITIVE	
οἶδα	οἶδα	VB	person=PERSON_1|number=SINGULAR|tense=PERF|mood=INDICATIVE|voice=ACTIVE	
δ̓	δε	CONJ	_	
ἐπηλυσίης	ἐπηλυσία	NN	number=SINGULAR|gender=FEMININE|case=GENITIVE	
πολυπήμονος	πολυπήμων	ADJ	number=SINGULAR|case=GENITIVE	
ἐσθλὸν	ἐσθλός	ADJ	number=SINGULAR|gender=MASCULINE|case=ACCUSATIVE	
ἐρυσμόν	ἐρυσμός	NN	number=SINGULAR|gender=MASCULINE|case=ACCUSATIVE	
φῆ	φημί	VB	person=PERSON_3|number=SINGULAR|tense=IMP|mood=INDICATIVE|voice=ACTIVE	
ῥα	ἄρα	ADV	_	
θεά	θεά	NN	number=SINGULAR|gender=FEMININE|case=NOMINATIVE	
γήθησεν	γηθέω	VB	person=PERSON_3|number=SINGULAR|mood=INDICATIVE|voice=ACTIVE	
δὲ	δὲ	CONJ	_	
περίφρων	περίφρων	ADJ	number=SINGULAR|gender=FEMININE|case=NOMINATIVE	
Περσεφόνεια	Περσεφόνεια	NN	number=SINGULAR|gender=FEMININE|case=NOMINATIVE	
καρπαλίμως	καρπαλίμος	ADV	_	
δ̓	δε	CONJ	_	
ἀνόρουσ̓	ἀνόρουω	VB	person=PERSON_3|number=SINGULAR|mood=INDICATIVE|voice=ACTIVE	
ὑπὸ	ὑπό	PREP	_	
χάρματος	χάρμα	NN	number=SINGULAR|gender=NEUTER|case=GENITIVE	
ἣ	ὁ	PRON	number=SINGULAR|gender=FEMININE|case=NOMINATIVE	
δ̓	δε	CONJ	_	
ἄῤ	ἄρα	ADV	_	
ὄπισθε	ὄπισθε	PREP	_	
φίλον	φίλος	ADJ	number=SINGULAR|gender=MASCULINE|case=ACCUSATIVE	
τετιημένη	τετίημαι	VB	number=SINGULAR|tense=PERF|mood=PARTICIPLE|gender=FEMININE|case=NOMINATIVE	
ἦτορ	ἦτορ	NN	number=SINGULAR|gender=NEUTER|case=ACCUSATIVE	
στεῖχε	στείχω	VB	person=PERSON_3|number=SINGULAR|tense=IMP|mood=INDICATIVE|voice=ACTIVE	
κατὰ	κατά	PREP	_	
κρῆθεν	κράς	NN	number=SINGULAR|case=GENITIVE	
κεκαλυμμένη	καλύπτω	VB	number=SINGULAR|tense=PERF|mood=PARTICIPLE|gender=FEMININE|case=NOMINATIVE	
νῦν	νῦν	ADV	_	
δ̓	δε	CONJ	_	
ἐπεὶ	ἐπεί	CONJ	_	
ἵκεο	ἱκνέομαι	VB	person=PERSON_2|number=SINGULAR|mood=INDICATIVE	
δεῦρο	δεῦρο	ADV	_	
παρέσσεται	πάρειμι	VB	person=PERSON_3|number=SINGULAR|tense=FUTURE|mood=INDICATIVE	
ὅσσα	ὅσος	ADJ	number=PLURAL|gender=NEUTER|case=NOMINATIVE	
τ̓	τε	ADV	_	
ἐμοί	ἐγώ	PRON	person=PERSON_1|number=SINGULAR|gender=FEMININE|case=DATIVE	
περ	πέρ	ADV	_	
τὴν	ὁ	PRON	number=SINGULAR|gender=FEMININE|case=ACCUSATIVE	
δ̓	δε	CONJ	_	
ὧδε	ὧδε	ADV	_	
προσέειπε	προσεῖπον	VB	person=PERSON_3|number=SINGULAR|mood=INDICATIVE|voice=ACTIVE	
Ῥέη	Ῥέα	NN	number=SINGULAR|gender=FEMININE|case=NOMINATIVE	
λιπαροκρήδεμνος	λιπαροκρήδεμνος	ADJ	number=SINGULAR|gender=FEMININE|case=NOMINATIVE	
ἴστω	οἶδα	VB	person=PERSON_3|number=SINGULAR|tense=PERF|mood=IMPERATIVE|voice=ACTIVE	
γὰρ	γάρ	ADV	_	
θεῶν	θεὸς	NN	number=PLURAL|gender=MASCULINE|case=GENITIVE	
ὅρκος	ὅρκος	NN	number=SINGULAR|gender=MASCULINE|case=NOMINATIVE	
ἀμείλικτον	ἀμείλικτος	ADJ	number=SINGULAR|gender=NEUTER|case=VOCATIVE	
Στυγὸς	Στύξ	NN	number=SINGULAR|gender=FEMININE|case=GENITIVE	
ὕδωρ	ὕδωρ	NN	number=SINGULAR|gender=NEUTER|case=VOCATIVE	
ἀθάνατόν	ἀθάνατος	ADJ	number=SINGULAR|gender=MASCULINE|case=ACCUSATIVE	
κέν	ἄν	ADV	_	
τοι	τοι	ADV	_	
καὶ	καί	CONJ	_	
ἀγήραον	ἀγήραος	ADJ	number=SINGULAR|gender=MASCULINE|case=ACCUSATIVE	
ἤματα	ἦμαρ	NN	number=PLURAL|gender=NEUTER|case=ACCUSATIVE	
πάντα	πᾶς	ADJ	number=PLURAL|gender=NEUTER|case=ACCUSATIVE	
παῖδα	παῖς	NN	number=SINGULAR|gender=MASCULINE|case=ACCUSATIVE	
φίλον	φίλος	ADJ	number=SINGULAR|gender=MASCULINE|case=ACCUSATIVE	
ποίησα	ποιέω	VB	person=PERSON_1|number=SINGULAR|mood=INDICATIVE|voice=ACTIVE	
καὶ	καί	CONJ	_	
ἄφθιτον	ἄφθιτος	ADJ	number=SINGULAR|gender=FEMININE|case=ACCUSATIVE	
ὤπασα	ὀπάζω	VB	person=PERSON_1|number=SINGULAR|mood=INDICATIVE|voice=ACTIVE	
τιμήν	τιμή	NN	number=SINGULAR|gender=FEMININE|case=ACCUSATIVE	
ἁρπάξας	ἁρπάζω	VB	number=SINGULAR|mood=PARTICIPLE|voice=ACTIVE|gender=MASCULINE|case=NOMINATIVE	
δ̓	δε	CONJ	_	
ἀέκουσαν	ἀέκων	ADJ	number=SINGULAR|gender=FEMININE|case=ACCUSATIVE	
ἐπὶ	ἐπί	PREP	_	
χρυσέοισιν	χρύσεος	ADJ	number=PLURAL|gender=MASCULINE|case=DATIVE	
ὄχοισιν	ὄχος	NN	number=PLURAL|gender=MASCULINE|case=DATIVE	
ἦγ̓	ἄγω	VB	person=PERSON_3|number=SINGULAR|tense=IMP|mood=INDICATIVE|voice=ACTIVE	
ὀλοφυρομένην	ὀλοφύρομαι	VB	number=SINGULAR|tense=PR|mood=PARTICIPLE|gender=FEMININE|case=ACCUSATIVE	
οὐ	οὐ	ADV	_	
μὲν	μέν	ADV	_	
γάρ	γάρ	ADV	_	
ποτ̓	ποτε	ADV	_	
ἔφασκε	φάσκω	VB	person=PERSON_3|number=SINGULAR|tense=IMP|mood=INDICATIVE|voice=ACTIVE	
θυώδεος	θυώδης	ADJ	number=SINGULAR|gender=MASCULINE|case=GENITIVE	
Οὐλύμποιο	Ὄλυμπος	NN	number=SINGULAR|gender=MASCULINE|case=GENITIVE	
πρίν	πρίν	CONJ	_	
γ̓	γε	ADV	_	
ἐπιβήσεσθαι	ἐπιβαίνω	VB	tense=FUTURE|mood=INFINITIVE	
οὐ	οὐ	ADV	_	
πρὶν	πρὶν	CONJ	_	
γῆς	γῆ	NN	number=SINGULAR|gender=FEMININE|case=GENITIVE	
καρπὸν	καρπός	NN	number=SINGULAR|gender=MASCULINE|case=ACCUSATIVE	
ἀνήσειν	ἀνίημι	VB	tense=FUTURE|mood=INFINITIVE|voice=ACTIVE	
πρὶν	πρὶν	CONJ	_	
ἴδοι	εἶδον	VB	person=PERSON_3|number=SINGULAR|voice=ACTIVE	
ὀφθαλμοῖσιν	ὀφθαλμός	NN	number=PLURAL|gender=MASCULINE|case=DATIVE	
ἑὴν	ἑός	ADJ	number=SINGULAR|gender=FEMININE|case=ACCUSATIVE	
εὐώπιδα	εὐώπις	ADJ	number=SINGULAR|gender=FEMININE|case=ACCUSATIVE	
κούρην	κόρη	NN	number=SINGULAR|gender=FEMININE|case=ACCUSATIVE	
αἶψα	αἶψα	ADV	_	
δέ	δέ	CONJ	_	
οἱ	ὁ	PRON	number=PLURAL|gender=MASCULINE|case=NOMINATIVE	
πέμπουσιν	πέμπω	VB	person=PERSON_3|number=PLURAL|tense=PR|mood=INDICATIVE|voice=ACTIVE	
ἐφέστιον	ἐφέστιον	ADV	_	
ἐς	εἰς	PREP	_	
μέγα	μέγας	ADJ	number=SINGULAR|gender=NEUTER|case=ACCUSATIVE	
δῶμα	δῶμα	NN	number=SINGULAR|gender=NEUTER|case=ACCUSATIVE	
Πλοῦτον	Πλοῦτος	NN	number=SINGULAR|gender=MASCULINE|case=ACCUSATIVE	
ὃς	ὅς	PRON	number=SINGULAR|gender=MASCULINE|case=NOMINATIVE	
ἀνθρώποις	ἄνθρωπος	NN	number=PLURAL|gender=MASCULINE|case=DATIVE	
ἄφενος	ἄφενος	NN	number=SINGULAR|gender=NEUTER|case=ACCUSATIVE	
θνητοῖσι	θνητός	ADJ	number=PLURAL|gender=MASCULINE|case=DATIVE	
δίδωσιν	δίδωμι	VB	person=PERSON_3|number=SINGULAR|tense=PR|mood=INDICATIVE|voice=ACTIVE	
γηθοσύνας	γηθοσύνη	NN	number=PLURAL|gender=FEMININE|case=ACCUSATIVE	
δ̓	δε	CONJ	_	
ἐδέχοντο	δέχομαι	VB	person=PERSON_3|number=PLURAL|tense=IMP|mood=INDICATIVE	
παῤ	παρα	PREP	_	
ἀλλήλων	ἀλλήλων	PRON	number=PLURAL|gender=FEMININE|case=GENITIVE	
ἔδιδόν	δίδωμι	VB	person=PERSON_3|number=PLURAL|tense=IMP|mood=INDICATIVE|voice=ACTIVE	
τε	τε	CONJ	_	
ἀλλ̓	ἀλλα	CONJ	_	
ἴθι	εἶμι	VB	person=PERSON_2|number=SINGULAR|tense=PR|mood=IMPERATIVE|voice=ACTIVE	
τέκνον	τέκνον	NN	number=SINGULAR|gender=NEUTER|case=VOCATIVE	
ἐμόν	ἐμός	ADJ	number=SINGULAR|gender=NEUTER|case=VOCATIVE	
καὶ	καί	CONJ	_	
πείθεο	πείθω	VB	person=PERSON_2|number=SINGULAR|tense=PR|mood=IMPERATIVE	
μηδέ	μηδέ	CONJ	_	
τι	τι	ADV	_	
λίην	λίαν	ADV	_	
ἀ[ζηχὲς	ἀζηχής	ADJ	number=SINGULAR|gender=NEUTER|case=ACCUSATIVE	
μεν]έαινε	μενεαίνω	VB	person=PERSON_2|number=SINGULAR|tense=PR|mood=IMPERATIVE|voice=ACTIVE	
κελαινεφέι	κελαινεφής	ADJ	number=SINGULAR|case=DATIVE	
Κρονίωνι	Κρονίων	NN	number=SINGULAR|gender=MASCULINE|case=DATIVE	
χειρότεραι	χερείων	ADJ	number=PLURAL|gender=FEMININE|case=NOMINATIVE	
γὰρ	γάρ	ADV	_	
δή	δή	ADV	_	
μιν	μιν	PRON	person=PERSON_3|number=SINGULAR|gender=MASCULINE|case=ACCUSATIVE	
ἔχον	ἔχω	VB	person=PERSON_3|number=PLURAL|tense=IMP|mood=INDICATIVE|voice=ACTIVE	
τροφοὶ	τροφός	NN	number=PLURAL|gender=FEMININE|case=NOMINATIVE	
ἠδὲ	ἠδέ	CONJ	_	
τιθῆναι	τιθήνη	NN	number=PLURAL|gender=FEMININE|case=NOMINATIVE	
χωσαμένη	χώομαι	VB	number=SINGULAR|mood=PARTICIPLE|gender=FEMININE|case=NOMINATIVE	
δὴ	δή	ADV	_	
ἔπειτα	ἔπειτα	ADV	_	
κελαινεφέι	κελαινεφής	ADJ	number=SINGULAR|case=DATIVE	
Κρονίωνι	Κρονίων	NN	number=SINGULAR|gender=MASCULINE|case=DATIVE	
νοσφισθεῖσα	νοσφίζω	VB	number=SINGULAR|mood=PARTICIPLE|voice=PASSIVE|gender=FEMININE|case=NOMINATIVE	
θεῶν	θεὸς	NN	number=PLURAL|gender=MASCULINE|case=GENITIVE	
ἀγορὴν	ἀγορά	NN	number=SINGULAR|gender=FEMININE|case=ACCUSATIVE	
καὶ	καί	CONJ	_	
μακρὸν	μακρός	ADJ	number=SINGULAR|gender=MASCULINE|case=ACCUSATIVE	
Ὄλυμπον	Ὄλυμπος	NN	number=SINGULAR|gender=MASCULINE|case=ACCUSATIVE	
ᾤχετ̓	οἴχομαι	VB	person=PERSON_3|number=SINGULAR|mood=INDICATIVE	
ἐπ̓	ἐπι	PREP	_	
ἀνθρώπων	ἄνθρωπος	NN	number=PLURAL|gender=MASCULINE|case=GENITIVE	
πόλιας	πόλις	NN	number=PLURAL|gender=FEMININE|case=ACCUSATIVE	
καὶ	καί	CONJ	_	
πίονα	πίων	ADJ	number=PLURAL|gender=NEUTER|case=ACCUSATIVE	
ἔργα	ἔργον	NN	number=PLURAL|gender=NEUTER|case=ACCUSATIVE	
εἶδος	εἶδος	NN	number=SINGULAR|gender=NEUTER|case=ACCUSATIVE	
ἀμαλδύνουσα	ἀμαλδύνω	VB	number=SINGULAR|tense=PR|mood=PARTICIPLE|voice=ACTIVE|gender=FEMININE|case=NOMINATIVE	
πολὺν	πολύς	ADJ	number=SINGULAR|gender=MASCULINE|case=ACCUSATIVE	
χρόνον	χρόνος	NN	number=SINGULAR|gender=MASCULINE|case=ACCUSATIVE	
τὴν	ὁ	PRON	number=SINGULAR|gender=FEMININE|case=ACCUSATIVE	
δ̓	δε	CONJ	_	
αὖ	αὖ	ADV	_	
Περσεφόνη	Περσεφόνη	NN	number=SINGULAR|gender=FEMININE|case=NOMINATIVE	
περικαλλὴς	περικαλλής	ADJ	number=SINGULAR|gender=FEMININE|case=NOMINATIVE	
ἀντίον	ἀντίος	ADJ	number=SINGULAR|gender=FEMININE|case=ACCUSATIVE	
ηὔδα	αὐδάω	VB	person=PERSON_3|number=SINGULAR|tense=IMP|mood=INDICATIVE|voice=ACTIVE	
αὖτις	αὖθις	ADV	_	
ἔπειτα	ἔπειτα	ADV	_	
πατὴρ	πατήρ	NN	number=SINGULAR|gender=MASCULINE|case=NOMINATIVE	
μάκαρας	μάκαρ	ADJ	number=PLURAL|gender=MASCULINE|case=ACCUSATIVE	
θεοὺς	θεός	NN	number=PLURAL|gender=MASCULINE|case=ACCUSATIVE	
αἰὲν	ἀεί	ADV	_	
ἐόντας	εἰμί	VB	number=PLURAL|tense=PR|mood=PARTICIPLE|voice=ACTIVE|gender=MASCULINE|case=ACCUSATIVE	
πάντας	πᾶς	ADJ	number=PLURAL|gender=MASCULINE|case=ACCUSATIVE	
ἐπιπροΐαλλεν	ἐπιπροιάλλω	VB	person=PERSON_3|number=SINGULAR|tense=IMP|mood=INDICATIVE|voice=ACTIVE	
ὣς	ὣς	CONJ	_	
ἔφατ̓	φῆμι	VB	person=PERSON_3|number=SINGULAR|tense=IMP|mood=INDICATIVE|voice=ACTIVE	
μέγ̓	μέγας	ADV	_	
ὄλβιος	ὄλβιος	ADJ	number=SINGULAR|gender=MASCULINE|case=NOMINATIVE	
ὅν	ὅς	PRON	number=SINGULAR|gender=MASCULINE|case=ACCUSATIVE	
τιν̓	τις	PRON	number=SINGULAR|gender=MASCULINE|case=ACCUSATIVE	
ἐκεῖναι	ἐκεῖνος	PRON	number=PLURAL|gender=FEMININE|case=NOMINATIVE	
προφρονέως	πρόφρων	ADV	_	
φίλωνται	φιλέω	VB	person=PERSON_3|number=PLURAL|mood=SUBJUNCTIVE	
ἐπιχθονίων	ἐπιχθόνιος	ADJ	number=PLURAL|gender=MASCULINE|case=GENITIVE	
ἀνθρώπων	ἄνθρωπος	NN	number=PLURAL|gender=MASCULINE|case=GENITIVE	
ἐστιν	εἰμί	VB	person=PERSON_3|number=SINGULAR|tense=PR|mood=INDICATIVE|voice=ACTIVE	
ἀμφὶ	ἀμφὶ	ADV	_	
δὲ	δὲ	CONJ	_	
τιμὴν	τιμή	NN	number=SINGULAR|gender=FEMININE|case=ACCUSATIVE	
ἔλλαχεν	λαγχάνω	VB	person=PERSON_3|number=SINGULAR|mood=INDICATIVE|voice=ACTIVE	
ὡς	ὡς	CONJ	_	
τὰ	ὁ		number=PLURAL|gender=NEUTER|case=ACCUSATIVE	
πρῶτα	πρῶτος	ADJ	number=PLURAL|gender=NEUTER|case=ACCUSATIVE	
διάτριχα	διάτριχα	ADV	_	
δασμὸς	δασμός	NN	number=SINGULAR|gender=MASCULINE|case=NOMINATIVE	
ἐτύχθη	τεύχω	VB	person=PERSON_3|number=SINGULAR|mood=INDICATIVE|voice=PASSIVE	
τοῖς	ὁ		number=PLURAL|gender=NEUTER|case=DATIVE	
μεταναιετάειν	μεταναιετάω	VB	tense=PR|mood=INFINITIVE|voice=ACTIVE	
τῶν	ὁ	PRON	number=PLURAL|gender=MASCULINE|case=GENITIVE	
ἔλλαχε	λαγχάνω	VB	person=PERSON_3|number=SINGULAR|mood=INDICATIVE|voice=ACTIVE	
κοίρανος	κοίρανος	NN	number=SINGULAR|gender=MASCULINE|case=NOMINATIVE	
εἶναι	εἰμί	VB	tense=PR|mood=INFINITIVE|voice=ACTIVE	
ὁ	ὁ	PRON	number=SINGULAR|gender=MASCULINE|case=NOMINATIVE	
ἀλλ̓	ἀλλα	CONJ	_	
οὐ	οὐ	ADV	_	
Δημήτηρ	Δημήτηρ	NN	number=SINGULAR|gender=FEMININE|case=NOMINATIVE	
ὡρηφόρος	ὡρηφόρος	ADJ	number=SINGULAR|gender=FEMININE|case=NOMINATIVE	
ἀγλαόδωρος	ἀγλαόδωρος	ADJ	number=SINGULAR|gender=FEMININE|case=NOMINATIVE	
ἤθελεν	ἐθέλω	VB	person=PERSON_3|number=SINGULAR|tense=IMP|mood=INDICATIVE|voice=ACTIVE	
ἑδριάασθαι	ἑδριάω	VB	tense=PR|mood=INFINITIVE	
ἐπὶ	ἐπί	PREP	_	
κλισμοῖο	κλισμός	NN	number=SINGULAR|gender=MASCULINE|case=GENITIVE	
φαεινοῦ	φαεινός	ADJ	number=SINGULAR|gender=MASCULINE|case=GENITIVE	
ἀλλ̓	ἀλλα	CONJ	_	
ἀκέουσ̓	ἀκέων	ADJ	number=SINGULAR|gender=FEMININE|case=NOMINATIVE	
ἀνέμιμνε	ἀναμίμνω	VB	person=PERSON_3|number=SINGULAR|tense=IMP|mood=INDICATIVE|voice=ACTIVE	
κατ̓	κατα	ADV	_	
ὄμματα	ὄμμα	NN	number=PLURAL|gender=NEUTER|case=ACCUSATIVE	
καλὰ	καλός	ADJ	number=PLURAL|gender=NEUTER|case=ACCUSATIVE	
βαλοῦσα	βάλλω	VB	number=SINGULAR|mood=PARTICIPLE|voice=ACTIVE|gender=FEMININE|case=NOMINATIVE	
πρίν	πρίν	CONJ	_	
γ̓	γε	ADV	_	
ὅτε	ὅτε	ADV	_	
δή	δή	ADV	_	
οἱ	ἕ	PRON	number=SINGULAR|gender=FEMININE|case=DATIVE	
ἔθηκεν	τίθημι	VB	person=PERSON_3|number=SINGULAR|mood=INDICATIVE|voice=ACTIVE	
Ἰάμβη	Ἰάμβη	NN	number=SINGULAR|gender=FEMININE|case=NOMINATIVE	
κέδν̓	κέδνος	ADJ	number=PLURAL|gender=NEUTER|case=ACCUSATIVE	
εἰδυῖα	οἶδα	VB	number=SINGULAR|tense=PERF|mood=PARTICIPLE|voice=ACTIVE|gender=FEMININE|case=NOMINATIVE	
πηκτὸν	πηκτός	ADJ	number=SINGULAR|gender=NEUTER|case=ACCUSATIVE	
ἕδος	ἕδος	NN	number=SINGULAR|gender=NEUTER|case=ACCUSATIVE	
καθύπερθε	καθύπερθε	ADV	_	
δ̓	δε	CONJ	_	
ἐπ̓	ἐπι	PREP	_	
ἀργύφεον	ἀργύφεος	ADJ	number=SINGULAR|gender=MASCULINE|case=ACCUSATIVE	
βάλε	βάλλω	VB	person=PERSON_3|number=SINGULAR|mood=INDICATIVE|voice=ACTIVE	
κῶας	κῶας	NN	number=SINGULAR|gender=NEUTER|case=ACCUSATIVE	
ταῦτα	οὗτος	PRON	number=PLURAL|gender=NEUTER|case=ACCUSATIVE	
δέ	δέ	CONJ	_	
τοι	σύ	PRON	person=PERSON_2|number=SINGULAR|case=DATIVE	
σαφέως	σαφής	ADJ	_	
ὑποθήσομαι	ὑποτίθημι	VB	person=PERSON_1|number=SINGULAR|tense=FUTURE|mood=INDICATIVE	
ἠδ̓	ἠδη	CONJ	_	
ὀνομήνω	ὀνομαίνω	VB	person=PERSON_1|number=SINGULAR|mood=SUBJUNCTIVE|voice=ACTIVE	
ἀνέρας	ἀνήρ	NN	number=PLURAL|gender=MASCULINE|case=ACCUSATIVE	
οἷσιν	ὅς	PRON	number=PLURAL|gender=MASCULINE|case=DATIVE	
ἔπεστι	ἔπειμι	VB	person=PERSON_3|number=SINGULAR|tense=PR|mood=INDICATIVE|voice=ACTIVE	
μέγα	μέγας	ADJ	number=SINGULAR|gender=NEUTER|case=NOMINATIVE	
κράτος	κράτος	NN	number=SINGULAR|gender=NEUTER|case=NOMINATIVE	
ἐνθάδε	ἐνθάδε	ADV	_	
τιμῆς	τιμή	NN	number=SINGULAR|gender=FEMININE|case=GENITIVE	
δήμου	δῆμος	NN	number=SINGULAR|gender=MASCULINE|case=GENITIVE	
τε	τε	CONJ	_	
προὔχουσιν	προέχω	VB	number=PLURAL|tense=PR|mood=PARTICIPLE|voice=ACTIVE|gender=MASCULINE|case=DATIVE	
ἰδὲ	ἰδέ	CONJ	_	
κρήδεμνα	κρήδεμνον	NN	number=PLURAL|gender=NEUTER|case=NOMINATIVE	
πόληος	πόλις	NN	number=SINGULAR|gender=FEMININE|case=GENITIVE	
εἰρύαται	ἐρύω	VB	person=PERSON_3|number=PLURAL|tense=PERF|mood=INDICATIVE	
βουλῇσι	βουλή	NN	number=PLURAL|gender=FEMININE|case=DATIVE	
καὶ	καί	CONJ	_	
ἰθείῃσι	ἰθύς	ADJ	number=PLURAL|gender=FEMININE|case=DATIVE	
δίκῃσιν	δίκη	NN	number=PLURAL|gender=FEMININE|case=DATIVE	
οἷσιν	ὅς	PRON	number=PLURAL|gender=MASCULINE|case=DATIVE	
Δωσὼ	Δωσὼ	NN	number=SINGULAR|gender=FEMININE|case=NOMINATIVE	
ἐμοί	ἐγώ	PRON	person=PERSON_1|number=SINGULAR|gender=FEMININE|case=DATIVE	
γ̓	γε	ADV	_	
ὄνομ̓	ὄνομα	NN	number=SINGULAR|gender=NEUTER|case=NOMINATIVE	
ἐστί	εἰμί	VB	person=PERSON_3|number=SINGULAR|tense=PR|mood=INDICATIVE|voice=ACTIVE	
ἀσπασίως	ἀσπασίος	ADV	_	
δ̓	δε	CONJ	_	
ἴδον	εἶδον	VB	person=PERSON_3|number=PLURAL|mood=INDICATIVE|voice=ACTIVE	
ἀλλήλας	ἀλλήλων	PRON	number=PLURAL|gender=FEMININE|case=ACCUSATIVE	
κεχάρηντο	χαίρω	VB	person=PERSON_3|number=PLURAL|tense=PLUSQUAMPERFECT|mood=INDICATIVE	
δὲ	δὲ	CONJ	_	
θυμῷ	θυμός	NN	number=SINGULAR|gender=MASCULINE|case=DATIVE	
τὴν	ὁ	PRON	number=SINGULAR|gender=FEMININE|case=ACCUSATIVE	
δ̓	δε	CONJ	_	
αὐτίκ̓	αὐτίκα	ADV	_	
ἀμείβετο	ἀμείβω	VB	person=PERSON_3|number=SINGULAR|tense=IMP|mood=INDICATIVE	
παρθένος	παρθένος	NN	number=SINGULAR|gender=FEMININE|case=NOMINATIVE	
ἀδμής	ἀδμής	NN	number=SINGULAR|gender=FEMININE|case=NOMINATIVE	
Καλλιδίκη	Καλλιδίκη	NN	number=SINGULAR|gender=FEMININE|case=NOMINATIVE	
Κελεοῖο	Κελεός	NN	number=SINGULAR|gender=MASCULINE|case=GENITIVE	
θυγατρῶν	θυγάτηρ	NN	number=PLURAL|gender=FEMININE|case=GENITIVE	
εἶδος	εἶδος	NN	number=SINGULAR|gender=NEUTER|case=ACCUSATIVE	
ἀρίστη	ἄριστος	ADJ	number=SINGULAR|gender=FEMININE|case=NOMINATIVE	
βῆ	βαίνω	VB	person=PERSON_3|number=SINGULAR|mood=INDICATIVE|voice=ACTIVE	
δὲ	δὲ	CONJ	_	
διὲκ	διέκ	PREP	_	
μεγάρων	μέγαρον	NN	number=PLURAL|gender=NEUTER|case=GENITIVE	
ἔρχεο	ἔρχομαι	VB	person=PERSON_2|number=SINGULAR|tense=PR|mood=IMPERATIVE	
Περσεφόνη	Φερσέφασσα	NN	number=SINGULAR|gender=FEMININE|case=VOCATIVE	
παρὰ	παρά	PREP	_	
μητέρα	μήτηρ	NN	number=SINGULAR|gender=FEMININE|case=ACCUSATIVE	
κυανόπεπλον	κυανόπεπλος	ADJ	number=SINGULAR|gender=FEMININE|case=ACCUSATIVE	
ἤπιον	ἤπιος	ADJ	number=SINGULAR|gender=FEMININE|case=ACCUSATIVE	
ἐν	ἐν	PREP	_	
στήθεσσι	στῆθος	NN	number=PLURAL|gender=NEUTER|case=DATIVE	
μένος	μένος	NN	number=SINGULAR|gender=NEUTER|case=ACCUSATIVE	
καὶ	καί	CONJ	_	
θυμὸν	θυμός	NN	number=SINGULAR|gender=MASCULINE|case=ACCUSATIVE	
ἔχουσα	ἔχω	VB	number=SINGULAR|tense=PR|mood=PARTICIPLE|voice=ACTIVE|gender=FEMININE|case=VOCATIVE	
μηδέ	μηδέ	CONJ	_	
τι	τι	ADV	_	
δυσθύμαινε	δυσθυμέω	VB	person=PERSON_2|number=SINGULAR|tense=PR|mood=IMPERATIVE|voice=ACTIVE	
λίην	λίαν	ADV	_	
περιώσιον	περιώσιος	ADJ	number=SINGULAR|gender=MASCULINE|case=ACCUSATIVE	
ἄλλων	ἄλλος	PRON	number=PLURAL|gender=MASCULINE|case=GENITIVE	
δεξαμένη	δέχομαι	VB	number=SINGULAR|mood=PARTICIPLE|gender=FEMININE|case=NOMINATIVE	
δ̓	δε	CONJ	_	
ὁσίης	ὁσία	NN	number=SINGULAR|gender=FEMININE|case=GENITIVE	
ἕνεκεν	ἕνεκα	PREP	_	
πολυπότνια	πολυπότνια	NN	number=SINGULAR|gender=FEMININE|case=NOMINATIVE	
Δηώ	Δηώ	NN	number=SINGULAR|gender=FEMININE|case=NOMINATIVE	
τῇσι	ὁ	PRON	number=PLURAL|gender=FEMININE|case=DATIVE	
δὲ	δέ	ADV	_	
μύθων	μῦθος	NN	number=PLURAL|gender=MASCULINE|case=GENITIVE	
ἦρχεν	ἄρχω	VB	person=PERSON_3|number=SINGULAR|tense=IMP|mood=INDICATIVE|voice=ACTIVE	
ἐύζωνος	εὔζωνος	ADJ	number=SINGULAR|gender=FEMININE|case=NOMINATIVE	
Μετάνειρα	Μετανείρα	NN	number=SINGULAR|gender=FEMININE|case=NOMINATIVE	
οὐδέ	οὐδέ	CONJ	_	
τις	τις	PRON	number=SINGULAR|gender=MASCULINE|case=NOMINATIVE	
ἀθανάτων	ἀθάνατος	ADJ	number=PLURAL|gender=MASCULINE|case=GENITIVE	
οὐδὲ	οὐδὲ	CONJ	_	
θνητῶν	θνητός	ADJ	number=PLURAL|gender=MASCULINE|case=GENITIVE	
ἀνθρώπων	ἄνθρωπος	NN	number=PLURAL|gender=MASCULINE|case=GENITIVE	
ἤκουσεν	ἀκούω	VB	person=PERSON_3|number=SINGULAR|mood=INDICATIVE|voice=ACTIVE	
φωνῆς	φωνή	NN	number=SINGULAR|gender=FEMININE|case=GENITIVE	
οὐδ̓	οὐδε	CONJ	_	
ἀγλαόκαρποι	ἀγλαόκαρπος	ADJ	number=PLURAL|gender=FEMININE|case=NOMINATIVE	
ἐλαῖαι	ἐλαία	NN	number=PLURAL|gender=FEMININE|case=NOMINATIVE	
εἰ	εἰ	CONJ	_	
μὴ	μὴ	ADV	_	
Περσαίου	Περσαῖος	NN	number=SINGULAR|gender=MASCULINE|case=GENITIVE	
θυγάτηρ	θυγάτηρ	NN	number=SINGULAR|gender=FEMININE|case=NOMINATIVE	
ἀταλὰ	ἀταλός	ADJ	number=SINGULAR|gender=FEMININE|case=NOMINATIVE	
φρονέουσα	φρονέω	VB	number=SINGULAR|tense=PR|mood=PARTICIPLE|voice=ACTIVE|gender=FEMININE|case=NOMINATIVE	
ἄιεν	ἀίω	VB	person=PERSON_3|number=SINGULAR|tense=IMP|mood=INDICATIVE|voice=ACTIVE	
ἐξ	ἐκ	PREP	_	
ἄντρου	ἄντρον	NN	number=SINGULAR|gender=NEUTER|case=GENITIVE	
Ἑκάτη	Ἑκάτη	NN	number=SINGULAR|gender=FEMININE|case=NOMINATIVE	
λιπαροκρήδεμνος	λιπαροκρήδεμνος	ADJ	number=SINGULAR|gender=FEMININE|case=NOMINATIVE	
Ἠέλιός	Ἥλιος	NN	number=SINGULAR|gender=MASCULINE|case=NOMINATIVE	
τε	τε	CONJ	_	
ἄναξ	ἄναξ	NN	number=SINGULAR|gender=MASCULINE|case=NOMINATIVE	
Ὑπερίονος	Ὑπερίων	NN	number=SINGULAR|gender=MASCULINE|case=GENITIVE	
ἀγλαὸς	ἀγλαός	ADJ	number=SINGULAR|gender=MASCULINE|case=NOMINATIVE	
υἱός	υἱός	NN	number=SINGULAR|gender=MASCULINE|case=NOMINATIVE	
κούρης	κόρη	NN	number=SINGULAR|gender=FEMININE|case=GENITIVE	
κεκλομένης	κέλομαι	VB	number=SINGULAR|mood=PARTICIPLE|gender=FEMININE|case=GENITIVE	
πατέρα	πατήρ	NN	number=SINGULAR|gender=MASCULINE|case=ACCUSATIVE	
Κρονίδην	Κρονίδης	NN	number=SINGULAR|gender=MASCULINE|case=ACCUSATIVE	
