οἳ	ὁ	PRON	number=PLURAL|gender=MASCULINE|case=NOMINATIVE	
δ̓	δέ		_	
ἄῤ	ἄρα		_	
ἐν	ἐν	PREP	_	
ἐλλεδανοῖσι	ἐλλεδανός	NN	number=PLURAL|gender=MASCULINE|case=DATIVE	
δέον	δέω	VB	person=PERSON_3|number=PLURAL|tense=IMP|mood=INDICATIVE|voice=ACTIVE	
καὶ	καί	CONJ	_	
ἔπιτνον	πίπτω	VB	person=PERSON_3|number=PLURAL|tense=IMP|mood=INDICATIVE|voice=ACTIVE	
ἀλωήν	ἀλωή	NN	number=SINGULAR|gender=FEMININE|case=ACCUSATIVE	
οἳ	ὁ	PRON	number=PLURAL|gender=MASCULINE|case=NOMINATIVE	
δ̓	δέ		_	
ἐτρύγων	τρυγάω	VB	person=PERSON_3|number=PLURAL|tense=IMP|mood=INDICATIVE|voice=ACTIVE	
οἴνας	οἴνη	NN	number=PLURAL|gender=FEMININE|case=ACCUSATIVE	
δρεπάνας	δρεπάνη	NN	number=PLURAL|gender=FEMININE|case=ACCUSATIVE	
ἐν	ἐν	PREP	_	
χερσὶν	χείρ	NN	number=PLURAL|gender=FEMININE|case=DATIVE	
ἔχοντες	ἔχω	VB	number=PLURAL|tense=PR|mood=PARTICIPLE|voice=ACTIVE|gender=MASCULINE|case=NOMINATIVE	
οἳ	ὁ	PRON	number=PLURAL|gender=MASCULINE|case=NOMINATIVE	
δ̓	δέ		_	
αὖτ̓	αὖτε	ADV	_	
ἐς	εἰς	PREP	_	
ταλάρους	τάλαρος	NN	number=PLURAL|gender=MASCULINE|case=ACCUSATIVE	
ἐφόρευν	φορέω	VB	person=PERSON_3|number=PLURAL|tense=IMP|mood=INDICATIVE|voice=ACTIVE	
ὑπὸ	ὑπό	PREP	_	
τρυγητήρων	τρυγητήρ	NN	number=PLURAL|gender=MASCULINE|case=GENITIVE	
λευκοὺς	λευκός	ADJ	number=PLURAL|gender=MASCULINE|case=ACCUSATIVE	
καὶ	καί	CONJ	_	
μέλανας	μέλας	ADJ	number=PLURAL|gender=MASCULINE|case=ACCUSATIVE	
βότρυας	βότρυς	NN	number=PLURAL|gender=MASCULINE|case=ACCUSATIVE	
μεγάλων	μέγας	ADJ	number=PLURAL|gender=MASCULINE|case=GENITIVE	
ἀπὸ	ἀπό	PREP	_	
ὄρχων	ὄρχος	NN	number=PLURAL|gender=MASCULINE|case=GENITIVE	
βριθομένων	βρίθω	VB	number=PLURAL|tense=PR|mood=PARTICIPLE|gender=MASCULINE|case=GENITIVE	
φύλλοισι	φύλλον	NN	number=PLURAL|gender=NEUTER|case=DATIVE	
καὶ	καί	CONJ	_	
ἀργυρέῃς	ἀργύρεος	ADJ	number=PLURAL|gender=FEMININE|case=DATIVE	
ἑλίκεσσιν	ἕλιξ	NN	number=PLURAL|gender=FEMININE|case=DATIVE	
τότε	τότε	ADV	_	
δή	δή		_	
ῥα	ἄρα		_	
διόγνητος	Διόγνητος	ADJ	number=SINGULAR|gender=MASCULINE|case=NOMINATIVE	
Ἰόλαος	Ἰόλαος	NN	number=SINGULAR|gender=MASCULINE|case=NOMINATIVE	
σμερδαλέον	σμερδαλέος	ADJ	number=SINGULAR|gender=NEUTER|case=ACCUSATIVE	
ἵπποισιν	ἵππος	NN	number=PLURAL|gender=MASCULINE|case=DATIVE	
ἐκέκλετο	κέλομαι	VB	person=PERSON_3|number=SINGULAR|mood=INDICATIVE	
πᾶσα	πᾶς	ADJ	number=SINGULAR|gender=FEMININE|case=NOMINATIVE	
δὲ	δέ		_	
Μυρμιδόνων	Μυρμιδόνες	NN	number=PLURAL|gender=MASCULINE|case=GENITIVE	
τε	τε		_	
πόλις	πόλις	NN	number=SINGULAR|gender=FEMININE|case=NOMINATIVE	
κλειτή	κλειτός	ADJ	number=SINGULAR|gender=FEMININE|case=NOMINATIVE	
τ̓	τε		_	
Ἰαωλκὸς	Ἰαωλκός	NN	number=SINGULAR|gender=FEMININE|case=NOMINATIVE	
Ἄρνη	Ἄρνη	NN	number=SINGULAR|gender=FEMININE|case=NOMINATIVE	
τ̓	τε		_	
ἠδ̓	ἠδέ	CONJ	_	
Ἑλίκη	Ἑλίκη	NN	number=SINGULAR|gender=FEMININE|case=NOMINATIVE	
Ἄνθειά	Ἄνθεια	NN	number=SINGULAR|gender=FEMININE|case=NOMINATIVE	
τε	τε		_	
ποιήεσσα	ποιήεις	ADJ	number=SINGULAR|gender=FEMININE|case=NOMINATIVE	
φωνῇ	φωνή	NN	number=SINGULAR|gender=FEMININE|case=DATIVE	
ὕπ̓	ὑπό	PREP	_	
ἀμφοτέρων	ἀμφότερος	ADJ	number=PLURAL|gender=MASCULINE|case=GENITIVE	
μεγάλ̓	μέγας	ADJ	number=PLURAL|gender=NEUTER|case=ACCUSATIVE	
ἴαχον	ἰάχω	VB	person=PERSON_3|number=PLURAL|tense=IMP|mood=INDICATIVE|voice=ACTIVE	
ἐπὶ	ἐπί	PREP	_	
δ̓	δέ		_	
ᾤχετο	οἴχομαι	VB	person=PERSON_3|number=SINGULAR|tense=IMP|mood=INDICATIVE	
φύλοπιν	φύλοπις	NN	number=SINGULAR|gender=FEMININE|case=ACCUSATIVE	
αἰνήν	αἰνός	ADJ	number=SINGULAR|gender=FEMININE|case=ACCUSATIVE	
ὦ	ὦ		_	
φίλος	φίλος	ADJ	number=SINGULAR|gender=MASCULINE|case=VOCATIVE	
ἀλλὰ	ἀλλά	ADV	_	
σὺ	σύ	PRON	number=SINGULAR|gender=MASCULINE|case=NOMINATIVE	
θᾶσσον	ταχύς	ADJ	number=SINGULAR|gender=NEUTER|case=ACCUSATIVE|degree=COMPARATIVE	
ἔχ̓	ἔχω	VB	person=PERSON_2|number=SINGULAR|tense=PR|mood=IMPERATIVE|voice=ACTIVE	
ἡνία	ἡνία	NN	number=PLURAL|gender=NEUTER|case=ACCUSATIVE	
φοινικόεντα	φοινικόεις	ADJ	number=PLURAL|gender=NEUTER|case=ACCUSATIVE	
ἵππων	ἵππος	NN	number=PLURAL|gender=MASCULINE|case=GENITIVE	
ὠκυπόδων	ὠκύπους	NN	number=PLURAL|gender=MASCULINE|case=GENITIVE	
ἀτὰρ	ἀτάρ		_	
γλαυκῶπις	γλαυκῶπις	ADJ	number=SINGULAR|gender=FEMININE|case=NOMINATIVE	
Ἀθήνη	Ἀθήνη	NN	number=SINGULAR|gender=FEMININE|case=NOMINATIVE	
ἐξίκετ̓	ἐξικνέομαι	VB	person=PERSON_3|number=SINGULAR|mood=INDICATIVE	
Οὔλυμπόν	Ὄλυμπος	NN	number=SINGULAR|gender=MASCULINE|case=ACCUSATIVE	
τε	τε		_	
μέγαν	μέγας	ADJ	number=SINGULAR|gender=MASCULINE|case=ACCUSATIVE	
καὶ	καί	CONJ	_	
δώματα	δῶμα	NN	number=PLURAL|gender=NEUTER|case=ACCUSATIVE	
πατρός	πατήρ	NN	number=SINGULAR|gender=MASCULINE|case=GENITIVE	
Κλωθὼ	Κλωθώ	NN	number=SINGULAR|gender=FEMININE|case=NOMINATIVE	
καὶ	καί	CONJ	_	
Λάχεσίς	Λάχεσις	NN	number=SINGULAR|gender=FEMININE|case=NOMINATIVE	
σφιν	σφεῖς	PRON	number=PLURAL|gender=FEMININE|case=DATIVE	
ἐφέστασαν	ἐφίστημι	VB	person=PERSON_3|number=PLURAL|tense=PLUSQUAMPERFECT|mood=INDICATIVE|voice=ACTIVE	
ἀλλ̓	ἀλλά	ADV	_	
ἄγε	ἄγε	ADV	_	
παῦε	παύω	VB	person=PERSON_2|number=SINGULAR|tense=PR|mood=IMPERATIVE|voice=ACTIVE	
μάχην	μάχη	NN	number=SINGULAR|gender=FEMININE|case=ACCUSATIVE	
μη	μή		_	
δ̓	δέ		_	
ἀντίος	ἀντίος	ADJ	number=SINGULAR|gender=MASCULINE|case=NOMINATIVE	
ἵστασ̓	ἵστημι	VB	person=PERSON_2|number=SINGULAR|tense=PR|mood=IMPERATIVE	
ἐμεῖο	ἐγώ	PRON	number=SINGULAR|gender=FEMININE|case=GENITIVE	
Ἆρες	Ἄρης	NN	number=SINGULAR|gender=MASCULINE|case=VOCATIVE	
ἔπισχε	ἐπίσχω	VB	person=PERSON_2|number=SINGULAR|tense=PR|mood=IMPERATIVE|voice=ACTIVE	
μένος	μένος	NN	number=SINGULAR|gender=NEUTER|case=ACCUSATIVE	
κρατερὸν	κρατερός	ADJ	number=SINGULAR|gender=NEUTER|case=ACCUSATIVE	
καὶ	καί	CONJ	_	
χεῖρας	χείρ	NN	number=PLURAL|gender=FEMININE|case=ACCUSATIVE	
ἀάπτους	ἄαπτος	ADJ	number=PLURAL|gender=FEMININE|case=ACCUSATIVE	
εἷμα	εἷμα	NN	number=SINGULAR|gender=NEUTER|case=ACCUSATIVE	
δ̓	δέ		_	
ἔχ̓	ἔχω	VB	person=PERSON_3|number=SINGULAR|tense=IMP|mood=INDICATIVE|voice=ACTIVE	
ἄμφ̓	ἀμφί	PREP	_	
ὤμοισι	ὦμος	NN	number=PLURAL|gender=MASCULINE|case=DATIVE	
δαφοινεὸν	δαφοινεός	ADJ	number=SINGULAR|gender=NEUTER|case=ACCUSATIVE	
αἵματι	αἷμα	NN	number=SINGULAR|gender=NEUTER|case=DATIVE	
φωτῶν	φώς	NN	number=PLURAL|gender=MASCULINE|case=GENITIVE	
δεινὸν	δεινός	ADJ	number=SINGULAR|gender=NEUTER|case=ACCUSATIVE	
δερκομένη	δέρκομαι	VB	number=SINGULAR|tense=PR|mood=PARTICIPLE|gender=FEMININE|case=NOMINATIVE	
καναχῇσί	καναχή	NN	number=PLURAL|gender=FEMININE|case=DATIVE	
τε	τε		_	
βεβρυχυῖα	βρυχάομαι	VB	number=SINGULAR|tense=PERF|mood=PARTICIPLE|voice=ACTIVE|gender=FEMININE|case=NOMINATIVE	
τοῖος	τοῖος	ADJ	number=SINGULAR|gender=MASCULINE|case=NOMINATIVE	
γὰρ	γάρ		_	
κραδίην	καρδία	NN	number=SINGULAR|gender=FEMININE|case=ACCUSATIVE	
πόθος	πόθος	NN	number=SINGULAR|gender=MASCULINE|case=NOMINATIVE	
αἴνυτο	αἴνυμαι	VB	person=PERSON_3|number=SINGULAR|tense=IMP|mood=INDICATIVE	
ποιμένα	ποιμήν	NN	number=SINGULAR|gender=MASCULINE|case=ACCUSATIVE	
λαῶν	λαός	NN	number=PLURAL|gender=MASCULINE|case=GENITIVE	
τῷ	ὁ	PRON	number=SINGULAR|gender=MASCULINE|case=DATIVE	
δ̓	δέ		_	
ἡνίοχος	ἡνίοχος	NN	number=SINGULAR|gender=MASCULINE|case=NOMINATIVE	
κρατερὸς	κρατερός	ADJ	number=SINGULAR|gender=MASCULINE|case=NOMINATIVE	
Ἰόλαος	Ἰόλαος	NN	number=SINGULAR|gender=MASCULINE|case=NOMINATIVE	
δίφρου	δίφρος	NN	number=SINGULAR|gender=MASCULINE|case=GENITIVE	
ἐπεμβεβαὼς	ἐπεμβαίνω	VB	number=SINGULAR|tense=PERF|mood=PARTICIPLE|voice=ACTIVE|gender=MASCULINE|case=NOMINATIVE	
ἰθύνετο	ἰθύνω	VB	person=PERSON_3|number=SINGULAR|tense=IMP|mood=INDICATIVE	
καμπύλον	καμπύλος	ADJ	number=SINGULAR|gender=NEUTER|case=ACCUSATIVE	
ἅρμα	ἅρμα	NN	number=SINGULAR|gender=NEUTER|case=ACCUSATIVE	
ὅς	ὅς	PRON	number=SINGULAR|gender=MASCULINE|case=NOMINATIVE	
ῥα	ἄρα		_	
τόθ̓	τότε	ADV	_	
ἡνίοχον	ἡνίοχος	NN	number=SINGULAR|gender=MASCULINE|case=ACCUSATIVE	
προσέφη	πρόσφημι	VB	person=PERSON_3|number=SINGULAR|tense=IMP|mood=INDICATIVE|voice=ACTIVE	
κρατερὸν	κρατερός	ADJ	number=SINGULAR|gender=MASCULINE|case=ACCUSATIVE	
Ἰόλαον	Ἰόλαος	NN	number=SINGULAR|gender=MASCULINE|case=ACCUSATIVE	
ὃ	ὁ	PRON	number=SINGULAR|gender=MASCULINE|case=NOMINATIVE	
δ̓	δέ		_	
ἐμμαπέως	ἐμμαπέως	ADV	_	
ὑπέδεκτο	ὑποδέχομαι	VB	person=PERSON_3|number=SINGULAR|mood=INDICATIVE	
ἀργύρεοι	ἀργύρεος	ADJ	number=PLURAL|gender=MASCULINE|case=NOMINATIVE	
χρύσεια	χρύσεος	ADJ	number=PLURAL|gender=NEUTER|case=ACCUSATIVE	
περὶ	περί	PREP	_	
χροῒ	χρώς	NN	number=SINGULAR|gender=MASCULINE|case=DATIVE	
τεύχἐ	τεῦχος	NN	number=PLURAL|gender=NEUTER|case=ACCUSATIVE	
ἔχοντες	ἔχω	VB	number=PLURAL|tense=PR|mood=PARTICIPLE|voice=ACTIVE|gender=MASCULINE|case=NOMINATIVE	
ἐν	ἐν	PREP	_	
δὲ	δέ		_	
συῶν	ὗς	NN	number=PLURAL|gender=MASCULINE|case=GENITIVE	
ἀγέλαι	ἀγέλη	NN	number=PLURAL|gender=FEMININE|case=NOMINATIVE	
χλούνων	χλούνης	NN	number=PLURAL|gender=MASCULINE|case=GENITIVE	
ἐν	ἐν	PREP	_	
μέσσῳ	μέσος	ADJ	number=SINGULAR|gender=NEUTER|case=DATIVE	
δ̓	δέ		_	
ἀδάμαντος	ἀδάμας	ADJ	number=SINGULAR|gender=MASCULINE|case=GENITIVE	
ἔην	εἰμί	VB	person=PERSON_3|number=SINGULAR|tense=IMP|mood=INDICATIVE|voice=ACTIVE	
Φόβος	φόβος	NN	number=SINGULAR|gender=MASCULINE|case=NOMINATIVE	
οὔ	οὐ	ADV	_	
τι	τις	PRON	number=SINGULAR|gender=NEUTER|case=ACCUSATIVE	
φατειός	φατειός	ADJ	number=SINGULAR|gender=MASCULINE|case=NOMINATIVE	
ἔμπαλιν	ἔμπαλιν	ADV	_	
ὄσσοισιν	ὄσσε	NN	number=PLURAL|gender=NEUTER|case=DATIVE	
πυρὶ	πῦρ	NN	number=SINGULAR|gender=NEUTER|case=DATIVE	
λαμπομένοισι	λάμπω	VB	number=PLURAL|tense=PR|mood=PARTICIPLE|gender=NEUTER|case=DATIVE	
δεδορκώς	δέρκομαι	VB	number=SINGULAR|tense=PERF|mood=PARTICIPLE|voice=ACTIVE|gender=MASCULINE|case=NOMINATIVE	
πᾶν	πᾶς	ADJ	number=SINGULAR|gender=NEUTER|case=NOMINATIVE	
δ̓	δέ		_	
ἄλσος	ἄλσος	NN	number=SINGULAR|gender=NEUTER|case=NOMINATIVE	
καὶ	καί	CONJ	_	
βωμὸς	βωμός	NN	number=SINGULAR|gender=MASCULINE|case=NOMINATIVE	
Ἀπόλλωνος	Ἀπόλλων	NN	number=SINGULAR|gender=MASCULINE|case=GENITIVE	
Παγασαίου	Παγασαῖος	NN	number=SINGULAR|gender=MASCULINE|case=GENITIVE	
λάμπεν	λάμπω	VB	person=PERSON_3|number=SINGULAR|tense=IMP|mood=INDICATIVE|voice=ACTIVE	
ὑπὸ	ὑπό	PREP	_	
δεινοῖο	δεινός	ADJ	number=SINGULAR|gender=MASCULINE|case=GENITIVE	
θεοῦ	θεός	NN	number=SINGULAR|gender=MASCULINE|case=GENITIVE	
τευχέων	τεῦχος	NN	number=PLURAL|gender=NEUTER|case=GENITIVE	
τε	τε		_	
καὶ	καί	CONJ	_	
αὐτοῦ	αὐτός	ADJ	number=SINGULAR|gender=MASCULINE|case=GENITIVE	
παρὰ	παρά	ADV	_	
δ̓	δέ		_	
ἰχθύες	ἰχθύς	NN	number=PLURAL|gender=MASCULINE|case=NOMINATIVE	
ἐκλονέοντο	κλονέω	VB	person=PERSON_3|number=PLURAL|tense=IMP|mood=INDICATIVE	
οἱ	ὁ		number=PLURAL|gender=MASCULINE|case=NOMINATIVE	
δ̓	δέ		_	
ἀροτῆρες	ἀροτήρ	NN	number=PLURAL|gender=MASCULINE|case=NOMINATIVE	
ἤρεικον	ἐρέικω	VB	person=PERSON_3|number=PLURAL|tense=IMP|mood=INDICATIVE|voice=ACTIVE	
χθόνα	χθών	NN	number=SINGULAR|gender=FEMININE|case=ACCUSATIVE	
δῖαν	δῖος	ADJ	number=SINGULAR|gender=FEMININE|case=ACCUSATIVE	
ἐπιστολάδην	ἐπιστολάδην	ADV	_	
δὲ	δέ		_	
χιτῶνας	χιτών	NN	number=PLURAL|gender=MASCULINE|case=ACCUSATIVE	
ἐστάλατ̓	στέλλω	VB	person=PERSON_3|number=PLURAL|tense=PLUSQUAMPERFECT|mood=INDICATIVE|voice=PASSIVE	
τοῦ	ὁ	PRON	number=SINGULAR|gender=MASCULINE|case=GENITIVE	
γὰρ	γάρ		_	
ὀπυίεις	ὀπυίω	VB	person=PERSON_2|number=SINGULAR|tense=PR|mood=INDICATIVE|voice=ACTIVE	
παῖδα	παῖς	NN	number=SINGULAR|gender=FEMININE|case=ACCUSATIVE	
Θεμιστονόην	Θεμιστονόη	NN	number=SINGULAR|gender=FEMININE|case=ACCUSATIVE	
κυανῶπιν	κυανῶπις	NN	number=SINGULAR|gender=FEMININE|case=ACCUSATIVE	
ἂψ	ἄψ	ADV	_	
δ̓	δέ		_	
ἀναχάσσασθαι	ἀναχάζω	VB	mood=INFINITIVE	
ἔρυτο	ῥύομαι	VB	person=PERSON_3|number=SINGULAR|mood=INDICATIVE	
δὲ	δέ		_	
δῶρα	δῶρον	NN	number=PLURAL|gender=NEUTER|case=NOMINATIVE	
θεοῖο	θεός	NN	number=SINGULAR|gender=MASCULINE|case=GENITIVE	
πῦρ	πῦρ	NN	number=SINGULAR|gender=NEUTER|case=NOMINATIVE	
δ̓	δέ		_	
ὣς	ὡς	ADV	_	
ὀφθαλμῶν	ὀφθαλμός	NN	number=PLURAL|gender=MASCULINE|case=GENITIVE	
ἀπελάμπετο	ἀπολάμπω	VB	person=PERSON_3|number=SINGULAR|tense=IMP|mood=INDICATIVE	
ἄνδρες	ἀνήρ	NN	number=PLURAL|gender=MASCULINE|case=NOMINATIVE	
δ̓	δέ		_	
οἳ	ὅς	PRON	number=PLURAL|gender=MASCULINE|case=NOMINATIVE	
πρεσβῆες	πρεσβεύς	NN	number=PLURAL|gender=MASCULINE|case=NOMINATIVE	
ἔσαν	εἰμί	VB	person=PERSON_3|number=PLURAL|tense=IMP|mood=INDICATIVE|voice=ACTIVE	
γῆράς	γῆρας	NN	number=SINGULAR|gender=NEUTER|case=NOMINATIVE	
τε	τε		_	
μέμαρπεν	μάρπτω	VB	person=PERSON_3|number=SINGULAR|tense=PERF|mood=INDICATIVE|voice=ACTIVE	
ἀθρόοι	ἀθρόος	ADJ	number=PLURAL|gender=MASCULINE|case=NOMINATIVE	
ἔκτοσθεν	ἔκτοσθε	PREP	_	
πυλέων	πύλη	NN	number=PLURAL|gender=FEMININE|case=GENITIVE	
ἔσαν	εἰμί	VB	person=PERSON_3|number=PLURAL|tense=IMP|mood=INDICATIVE|voice=ACTIVE	
ἂν	ἀνά	PREP	_	
δὲ	δέ		_	
θεοῖσι	θεός	NN	number=PLURAL|gender=MASCULINE|case=DATIVE	
χεῖρας	χείρ	NN	number=PLURAL|gender=FEMININE|case=ACCUSATIVE	
ἔχον	ἔχω	VB	person=PERSON_3|number=PLURAL|tense=IMP|mood=INDICATIVE|voice=ACTIVE	
μακάρεσσι	μάκαρ	NN	number=PLURAL|gender=MASCULINE|case=DATIVE	
περὶ	περί	PREP	_	
σφετέροισι	σφέτερος	ADJ	number=PLURAL|gender=NEUTER|case=DATIVE	
τέκεσσι	τέκος	NN	number=PLURAL|gender=NEUTER|case=DATIVE	
δειδιότες	δείδω	VB	number=PLURAL|tense=PERF|mood=PARTICIPLE|voice=ACTIVE|gender=MASCULINE|case=NOMINATIVE	
υἱὸς	υἱός	NN	number=SINGULAR|gender=MASCULINE|case=NOMINATIVE	
δ̓	δέ		_	
Ἀλκμήνης	Ἀλκμήνη	NN	number=SINGULAR|gender=FEMININE|case=GENITIVE	
καὶ	καί	CONJ	_	
κυδάλιμος	κυδάλιμος	ADJ	number=SINGULAR|gender=MASCULINE|case=NOMINATIVE	
Ἰόλαος	Ἰόλαος	NN	number=SINGULAR|gender=MASCULINE|case=NOMINATIVE	
Κύκνον	Κύκνος	NN	number=SINGULAR|gender=MASCULINE|case=ACCUSATIVE	
σκυλεύσαντες	σκυλεύω	VB	number=PLURAL|mood=PARTICIPLE|voice=ACTIVE|gender=MASCULINE|case=NOMINATIVE	
ἀπ̓	ἀπό	PREP	_	
ὤμων	ὦμος	NN	number=PLURAL|gender=MASCULINE|case=GENITIVE	
τεύχεα	τεῦχος	NN	number=PLURAL|gender=NEUTER|case=ACCUSATIVE	
καλὰ	καλός	ADJ	number=PLURAL|gender=NEUTER|case=ACCUSATIVE	
νίσσοντ̓	νίσσομαι	VB	person=PERSON_3|number=PLURAL|tense=IMP|mood=INDICATIVE	
κύκνε	Κύκνος	NN	number=SINGULAR|gender=MASCULINE|case=VOCATIVE	
πέπον	πέπων	ADJ	number=SINGULAR|gender=MASCULINE|case=VOCATIVE	
τί	τίς	PRON	number=SINGULAR|gender=NEUTER|case=ACCUSATIVE	
νυ	νῦν	ADV	_	
νῶιν	ἐγώ	PRON	gender=MASCULINE|case=DATIVE	
ἐπίσχετον	ἐπίσχω	VB	person=PERSON_2|tense=PR|mood=INDICATIVE|voice=ACTIVE	
ὠκέας	ὠκύς	ADJ	number=PLURAL|gender=MASCULINE|case=ACCUSATIVE	
ἵππους	ἵππος	NN	number=PLURAL|gender=MASCULINE|case=ACCUSATIVE	
ἀνδράσιν	ἀνήρ	NN	number=PLURAL|gender=MASCULINE|case=DATIVE	
οἵ	ὅς	PRON	number=PLURAL|gender=MASCULINE|case=NOMINATIVE	
τε	τε		_	
πόνου	πόνος	NN	number=SINGULAR|gender=MASCULINE|case=GENITIVE	
καὶ	καί	CONJ	_	
ὀιζύος	ὀιζύς	NN	number=SINGULAR|gender=FEMININE|case=GENITIVE	
ἴδριές	ἴδρις	NN	number=PLURAL|gender=MASCULINE|case=NOMINATIVE	
εἰμεν	εἰμί	VB	person=PERSON_1|number=PLURAL|tense=PR|mood=INDICATIVE|voice=ACTIVE	
ἐπὶ	ἐπί	PREP	_	
δὲ	δέ		_	
ζώνῃσι	ζώνη	NN	number=PLURAL|gender=FEMININE|case=DATIVE	
δράκοντε	δράκων	NN	gender=MASCULINE|case=NOMINATIVE	
δοιὼ	δοιώ	ADJ	gender=MASCULINE|case=NOMINATIVE	
ἀπῃωρεῦντ̓	ἀπαιωρέομαι	VB	person=PERSON_3|number=PLURAL|tense=IMP|mood=INDICATIVE	
ἐπικυρτώοντε	ἐπικυρτόω	VB	tense=PR|mood=PARTICIPLE|voice=ACTIVE|gender=MASCULINE|case=NOMINATIVE	
κάρηνα	κάρηνον	NN	number=PLURAL|gender=NEUTER|case=ACCUSATIVE	
πᾶσαι	πᾶς	ADJ	number=PLURAL|gender=FEMININE|case=NOMINATIVE	
δ̓	δέ		_	
ἀμφ̓	ἀμφί	PREP	_	
ἑνὶ	εἷς	NN	number=SINGULAR|gender=MASCULINE|case=DATIVE	
φωτὶ	φώς	NN	number=SINGULAR|gender=MASCULINE|case=DATIVE	
μάχην	μάχη	NN	number=SINGULAR|gender=FEMININE|case=ACCUSATIVE	
δριμεῖαν	δριμύς	ADJ	number=SINGULAR|gender=FEMININE|case=ACCUSATIVE	
ἔθεντο	τίθημι	VB	person=PERSON_3|number=PLURAL|mood=INDICATIVE	
πολλοὶ	πολύς	ADJ	number=PLURAL|gender=MASCULINE|case=NOMINATIVE	
δ̓	δέ		_	
ἔντοσθεν	ἔντοσθε	ADV	_	
ὀιστοὶ	ὀιστός	NN	number=PLURAL|gender=MASCULINE|case=NOMINATIVE	
ῥιγηλοί	ῥιγηλός	ADJ	number=PLURAL|gender=MASCULINE|case=NOMINATIVE	
θανάτοιο	θάνατος	NN	number=SINGULAR|gender=MASCULINE|case=GENITIVE	
λαθιφθόγγοιο	λαθίφθογγος	ADJ	number=SINGULAR|gender=MASCULINE|case=GENITIVE	
δοτῆρες	δοτήρ	NN	number=PLURAL|gender=MASCULINE|case=NOMINATIVE	
ἀλλ̓	ἀλλά	CONJ	_	
οὐ	οὐ	ADV	_	
πεῖθ̓	πείθω	VB	person=PERSON_3|number=SINGULAR|tense=IMP|mood=INDICATIVE|voice=ACTIVE	
Ἄρεος	Ἄρης	NN	number=SINGULAR|gender=MASCULINE|case=GENITIVE	
μεγαλήτορα	μεγαλήτωρ	ADJ	number=SINGULAR|gender=MASCULINE|case=ACCUSATIVE	
θυμόν	θυμός	NN	number=SINGULAR|gender=MASCULINE|case=ACCUSATIVE	
ἀλλὰ	ἀλλά	CONJ	_	
μέγα	μέγας	ADJ	number=SINGULAR|gender=NEUTER|case=ACCUSATIVE	
ἰάχων	ἰάχω	VB	number=SINGULAR|tense=PR|mood=PARTICIPLE|voice=ACTIVE|gender=MASCULINE|case=NOMINATIVE	
φλογὶ	φλόξ	NN	number=SINGULAR|gender=MASCULINE|case=DATIVE	
εἴκελά	εἴκελος	ADJ	number=PLURAL|gender=NEUTER|case=ACCUSATIVE	
τ̓	τε		_	
ἔγχεα	ἔγχος	NN	number=PLURAL|gender=NEUTER|case=ACCUSATIVE	
πάλλων	πάλλω	VB	number=SINGULAR|tense=PR|mood=PARTICIPLE|voice=ACTIVE|gender=MASCULINE|case=NOMINATIVE	
καρπαλίμως	καρπάλιμος	ADV	_	
ἐπόρουσε	ἐπορούω	VB	person=PERSON_3|number=SINGULAR|mood=INDICATIVE|voice=ACTIVE	
βίῃ	βία	NN	number=SINGULAR|gender=FEMININE|case=DATIVE	
Ἡρακληείῃ	Ἡράκλειος	ADJ	number=SINGULAR|gender=FEMININE|case=DATIVE	
κακτάμεναι	κατακτείνω	VB	tense=PERF|mood=INFINITIVE|voice=ACTIVE	
μεμαώς	μέμαα	VB	number=SINGULAR|tense=PERF|mood=PARTICIPLE|voice=ACTIVE|gender=MASCULINE|case=NOMINATIVE	
ἣ	ὁ	PRON	number=SINGULAR|gender=FEMININE|case=NOMINATIVE	
δ̓	δέ		_	
ἄπλητον	ἄπλατος	ADJ	number=SINGULAR|gender=NEUTER|case=ACCUSATIVE	
σεσαρυῖα	σαίρω	VB	number=SINGULAR|tense=PERF|mood=PARTICIPLE|voice=ACTIVE|gender=FEMININE|case=NOMINATIVE	
εἱστήκει	ἵστημι	VB	person=PERSON_3|number=SINGULAR|tense=PLUSQUAMPERFECT|mood=INDICATIVE|voice=ACTIVE	
πολλὴ	πολύς	ADJ	number=SINGULAR|gender=FEMININE|case=NOMINATIVE	
δὲ	δέ		_	
κόνις	κόνις	NN	number=SINGULAR|gender=FEMININE|case=NOMINATIVE	
κατενήνοθεν	ἐνήνοθε	VB	person=PERSON_3|number=SINGULAR|tense=PERF|mood=INDICATIVE|voice=ACTIVE	
ὤμους	ὦμος	NN	number=PLURAL|gender=MASCULINE|case=ACCUSATIVE	
δάκρυσι	δάκρυον	NN	number=PLURAL|gender=NEUTER|case=DATIVE	
μυδαλέη	μυδαλέος	ADJ	number=SINGULAR|gender=FEMININE|case=NOMINATIVE	
ταὶ	ὁ	PRON	number=PLURAL|gender=FEMININE|case=NOMINATIVE	
δὲ	δέ		_	
μετ̓	μετά	PREP	_	
αὐτὸν	αὐτός	ADJ	number=SINGULAR|gender=MASCULINE|case=ACCUSATIVE	
Γοργόνες	Γοργώ	NN	number=PLURAL|gender=FEMININE|case=NOMINATIVE	
ἄπλητοί	ἄπλατος	ADJ	number=PLURAL|gender=FEMININE|case=NOMINATIVE	
τε	τε		_	
καὶ	καί	CONJ	_	
οὐ	οὐ	ADV	_	
φαταὶ	φατός	ADJ	number=PLURAL|gender=FEMININE|case=NOMINATIVE	
ἐρρώοντο	ῥώομαι	VB	person=PERSON_3|number=PLURAL|tense=IMP|mood=INDICATIVE	
ἱέμεναι	ἵημι	VB	number=PLURAL|tense=PR|mood=PARTICIPLE|gender=FEMININE|case=NOMINATIVE	
μαπέειν	μάρπτω	VB	mood=INFINITIVE|voice=ACTIVE	
ἐμ	ἐν	PREP	_	
μένεος	μένος	NN	number=SINGULAR|gender=NEUTER|case=GENITIVE	
δ̓	δέ		_	
ἄρα	ἄρα		_	
τοῦ	ὁ	PRON	number=SINGULAR|gender=MASCULINE|case=GENITIVE	
γε	γε		_	
κελαινὸν	κελαινός	ADJ	number=SINGULAR|gender=NEUTER|case=NOMINATIVE	
πίμπλαται	πίμπλημι	VB	person=PERSON_3|number=SINGULAR|tense=PR|mood=INDICATIVE	
ἦτορ	ἦτορ	NN	number=SINGULAR|gender=NEUTER|case=NOMINATIVE	
[πολλοί	πολύς	ADJ	number=PLURAL|gender=MASCULINE|case=NOMINATIVE	
γε	γε		_	
μὲν	μέν		_	
ἂμ	ἀνά	PREP	_	
μέσον	μέσος	ADJ	number=SINGULAR|gender=NEUTER|case=ACCUSATIVE	
αὐτοῦ	αὐτός	ADJ	number=SINGULAR|gender=MASCULINE|case=GENITIVE	
δελφῖνες	δελφίς	NN	number=PLURAL|gender=MASCULINE|case=NOMINATIVE	
τῇ	τῇ	ADV	_	
καὶ	καί	CONJ	_	
τῇ	τῇ	ADV	_	
ἐθύνεον	θυνέω	VB	person=PERSON_3|number=PLURAL|tense=IMP|mood=INDICATIVE|voice=ACTIVE	
ἰχθυάοντες	ἰχθυάω	VB	number=PLURAL|tense=PR|mood=PARTICIPLE|voice=ACTIVE|gender=MASCULINE|case=NOMINATIVE	
νηχομένοις	νήχω	VB	number=PLURAL|tense=PR|mood=PARTICIPLE|gender=MASCULINE|case=DATIVE	
ἴκελοι	ἴκελος	ADJ	number=PLURAL|gender=MASCULINE|case=NOMINATIVE	
ἐν	ἐν	PREP	_	
δ̓	δέ		_	
ἦν	εἰμί	VB	person=PERSON_3|number=SINGULAR|tense=IMP|mood=INDICATIVE|voice=ACTIVE	
ἠυκόμου	εὔκομος	ADJ	number=SINGULAR|gender=FEMININE|case=GENITIVE	
Δανάης	Δανάη	NN	number=SINGULAR|gender=FEMININE|case=GENITIVE	
τέκος	τέκος	NN	number=SINGULAR|gender=NEUTER|case=NOMINATIVE	
ἱππότα	ἱππότης	NN	number=SINGULAR|gender=MASCULINE|case=NOMINATIVE	
Περσεύς	Περσεύς	NN	number=SINGULAR|gender=MASCULINE|case=NOMINATIVE	
οὔ	οὐ	ADV	_	
τ̓	τε		_	
ἄῤ	ἄρα		_	
ἐπιψαύων	ἐπιψαύω	VB	number=SINGULAR|tense=PR|mood=PARTICIPLE|voice=ACTIVE|gender=MASCULINE|case=NOMINATIVE	
σάκεος	σάκος	NN	number=SINGULAR|gender=NEUTER|case=GENITIVE	
ποσὶν	πούς	NN	number=PLURAL|gender=MASCULINE|case=DATIVE	
οὔθ̓	οὔτε	ADV	_	
ἑκὰς	ἑκάς	ADV	_	
αὐτοῦ	αὐτοῦ	ADV	_	
θαῦμα	θαῦμα	NN	number=SINGULAR|gender=NEUTER|case=NOMINATIVE	
μέγα	μέγας	ADJ	number=SINGULAR|gender=NEUTER|case=NOMINATIVE	
φράσσασθ̓	φράζω	VB	mood=INFINITIVE	
ἐπεὶ	ἐπεί	CONJ	_	
οὐδαμῇ	οὐδαμῇ	ADV	_	
ἐστήρικτο	στηρίζω	VB	person=PERSON_3|number=SINGULAR|tense=PLUSQUAMPERFECT|mood=INDICATIVE	
οὐ	οὐ	ADV	_	
δ̓	δέ		_	
ἄρα	ἄρα		_	
Κύκνος	Κύκνος	NN	number=SINGULAR|gender=MASCULINE|case=NOMINATIVE	
ἐυμμελίης	ἐυμμελίης	NN	number=SINGULAR|gender=MASCULINE|case=NOMINATIVE	
ἐμενοίνα	μενοινάω	VB	person=PERSON_3|number=SINGULAR|tense=IMP|mood=INDICATIVE|voice=ACTIVE	
τῷ	ὁ	PRON	number=SINGULAR|gender=MASCULINE|case=DATIVE	
ἐπιπειθόμενος	ἐπιπείθομαι	VB	number=SINGULAR|tense=PR|mood=PARTICIPLE|gender=MASCULINE|case=NOMINATIVE	
ἐχέμεν	ἔχω	VB	tense=PR|mood=INFINITIVE|voice=ACTIVE	
ἐρυσάρματας	ἐρυσάρματες	NN	number=PLURAL|gender=MASCULINE|case=ACCUSATIVE	
ἵππους	ἵππος	NN	number=PLURAL|gender=MASCULINE|case=ACCUSATIVE	
ὃν	ὅς	PRON	number=SINGULAR|gender=MASCULINE|case=ACCUSATIVE	
δὲ	δέ		_	
πρῶτον	πρῶτος	ADJ	number=SINGULAR|gender=MASCULINE|case=ACCUSATIVE|degree=SUPERLATIVE	
μεμάποιεν	μάρπτω	VB	person=PERSON_3|number=PLURAL|voice=ACTIVE	
κείμενον	κεῖμαι	VB	number=SINGULAR|tense=PR|mood=PARTICIPLE|gender=MASCULINE|case=ACCUSATIVE	
ἢ	ἤ	CONJ	_	
πίπτοντα	πίπτω	VB	number=SINGULAR|tense=PR|mood=PARTICIPLE|voice=ACTIVE|gender=MASCULINE|case=ACCUSATIVE	
νεούτατον	νεούτατος	ADJ	number=SINGULAR|gender=NEUTER|case=ACCUSATIVE	
ἀμφὶ	ἀμφί	PREP	_	
μὲν	μέν		_	
αὐτῷ	αὐτός	ADJ	number=SINGULAR|gender=MASCULINE|case=DATIVE	
βάλλ̓	βάλλω	VB	person=PERSON_3|number=SINGULAR|tense=IMP|mood=INDICATIVE|voice=ACTIVE	
ὄνυχας	ὄνυξ	NN	number=PLURAL|gender=MASCULINE|case=ACCUSATIVE	
μεγάλους	μέγας	ADJ	number=PLURAL|gender=MASCULINE|case=ACCUSATIVE	
ψυχὴ	ψυχή	NN	number=SINGULAR|gender=FEMININE|case=NOMINATIVE	
δ̓	δέ		_	
Ἄιδόσδε	ᾍδης	ADV	_	
κατῇεν	κάτειμι	VB	person=PERSON_3|number=SINGULAR|tense=IMP|mood=INDICATIVE|voice=ACTIVE	
Τάρταρον	Τάρταρος	NN	number=SINGULAR|gender=MASCULINE|case=ACCUSATIVE	
ἐς	εἰς	PREP	_	
κρυόενθ̓	κρυόεις	ADJ	number=SINGULAR|gender=MASCULINE|case=ACCUSATIVE	
ἔνθεν	ἔνθεν	ADV	_	
δ̓	δέ		_	
αὖθ̓	αὖτε	ADV	_	
ἑτέρωθε	ἑτέρωθεν	ADV	_	
νέοι	νέος	ADJ	number=PLURAL|gender=MASCULINE|case=NOMINATIVE	
κώμαζον	κωμάζω	VB	person=PERSON_3|number=PLURAL|tense=IMP|mood=INDICATIVE|voice=ACTIVE	
ὑπ̓	ὑπό	PREP	_	
αὐλοῦ	αὐλός	NN	number=SINGULAR|gender=MASCULINE|case=GENITIVE	
τοί	ὁ	PRON	number=PLURAL|gender=MASCULINE|case=NOMINATIVE	
γε	γε		_	
μὲν	μέν		_	
αὖ	αὖ	ADV	_	
παίζοντες	παίζω	VB	number=PLURAL|tense=PR|mood=PARTICIPLE|voice=ACTIVE|gender=MASCULINE|case=NOMINATIVE	
ὑπ̓	ὑπό	PREP	_	
ὀρχηθμῷ	ὀρχηθμός	NN	number=SINGULAR|gender=MASCULINE|case=DATIVE	
καὶ	καί	CONJ	_	
ἀοιδῇ	ἀοιδή	NN	number=SINGULAR|gender=FEMININE|case=DATIVE	
τοί	ὁ	PRON	number=PLURAL|gender=MASCULINE|case=NOMINATIVE	
γε	γε		_	
μὲν	μέν		_	
αὖ	αὖ	ADV	_	
γελόωντες	γελάω	VB	number=PLURAL|tense=PR|mood=PARTICIPLE|voice=ACTIVE|gender=MASCULINE|case=NOMINATIVE	
ὑπ̓	ὑπό	PREP	_	
αὐλητῆρι	αὐλητής	NN	number=SINGULAR|gender=MASCULINE|case=DATIVE	
ἕκαστος	ἕκαστος	ADJ	number=SINGULAR|gender=MASCULINE|case=NOMINATIVE	
πρόσθ̓	πρόσθεν	ADV	_	
ἔκιον	κίω	VB	person=PERSON_3|number=PLURAL|tense=IMP|mood=INDICATIVE|voice=ACTIVE	
τὼς	τώς	ADV	_	
γάρ	γάρ		_	
οἱ	ἕ	PRON	number=SINGULAR|gender=MASCULINE|case=DATIVE	
διέκειτο	διάκειμαι	VB	person=PERSON_3|number=SINGULAR|tense=IMP|mood=INDICATIVE	
θεοὶ	θεός	NN	number=PLURAL|gender=MASCULINE|case=NOMINATIVE	
δ̓	δέ		_	
ἐπὶ	ἐπί	PREP	_	
μάρτυροι	μάρτυρος	NN	number=PLURAL|gender=MASCULINE|case=NOMINATIVE	
ἦσαν	εἰμί	VB	person=PERSON_3|number=PLURAL|tense=IMP|mood=INDICATIVE|voice=ACTIVE	
οἵ	ὁ	PRON	number=PLURAL|gender=MASCULINE|case=NOMINATIVE	
γε	γε		_	
μὲν	μέν		_	
ἤμων	ἀμάω	VB	person=PERSON_3|number=PLURAL|tense=IMP|mood=INDICATIVE|voice=ACTIVE	
αἰχμῇς	αἰχμή	NN	number=PLURAL|gender=FEMININE|case=DATIVE	
ὀξείῃσι	ὀξύς	ADJ	number=PLURAL|gender=FEMININE|case=DATIVE	
κορωνιόωντα	κορωνιάω	VB	number=PLURAL|tense=PR|mood=PARTICIPLE|voice=ACTIVE|gender=NEUTER|case=ACCUSATIVE	
πέτηλα	πέτηλος	ADJ	number=PLURAL|gender=NEUTER|case=ACCUSATIVE	
βριθόμενα	βρίθω	VB	number=PLURAL|tense=PR|mood=PARTICIPLE|gender=NEUTER|case=ACCUSATIVE	
σταχύων	στάχυς	NN	number=PLURAL|gender=MASCULINE|case=GENITIVE	
ὡς	ὡς	ADV	_	
εἰ	εἰ	CONJ	_	
Δημήτερος	Δημήτηρ	NN	number=SINGULAR|gender=FEMININE|case=GENITIVE	
ἀκτήν	ἀκτή	NN	number=SINGULAR|gender=FEMININE|case=ACCUSATIVE	
οἳ	ὁ	PRON	number=PLURAL|gender=MASCULINE|case=NOMINATIVE	
δ̓	δέ		_	
αὐχένας	αὐχήν	NN	number=PLURAL|gender=MASCULINE|case=ACCUSATIVE	
ἐξεριπόντες	ἐξερείπω	VB	number=PLURAL|mood=PARTICIPLE|voice=ACTIVE|gender=MASCULINE|case=NOMINATIVE	
κείατο	κείμαι	VB	person=PERSON_3|number=PLURAL|tense=IMP|mood=INDICATIVE	
τεθνηῶτες	θνήσκω	VB	number=PLURAL|tense=PERF|mood=PARTICIPLE|voice=ACTIVE|gender=MASCULINE|case=NOMINATIVE	
ὑπὸ	ὑπό	PREP	_	
βλοσυροῖσι	βλοσυρός	ADJ	number=PLURAL|gender=MASCULINE|case=DATIVE	
λέουσιν	λέων	NN	number=PLURAL|gender=MASCULINE|case=DATIVE	
δεινὴ	δεινός	ADJ	number=SINGULAR|gender=FEMININE|case=NOMINATIVE	
δὲ	δέ		_	
περὶ	περί	PREP	_	
κροτάφοισιν	κρόταφος	NN	number=PLURAL|gender=MASCULINE|case=DATIVE	
ἄνακτος	ἄναξ	NN	number=SINGULAR|gender=MASCULINE|case=GENITIVE	
κεῖτ̓	κεῖμαι	VB	person=PERSON_3|number=SINGULAR|tense=IMP|mood=INDICATIVE	
Ἄιδος	ᾍδης	NN	number=SINGULAR|gender=MASCULINE|case=GENITIVE	
κυνέη	κυνέη	NN	number=SINGULAR|gender=FEMININE|case=NOMINATIVE	
νυκτὸς	νύξ	NN	number=SINGULAR|gender=FEMININE|case=GENITIVE	
ζόφον	ζόφος	NN	number=SINGULAR|gender=MASCULINE|case=ACCUSATIVE	
αἰνὸν	αἰνός	ADJ	number=SINGULAR|gender=MASCULINE|case=ACCUSATIVE	
ἔχουσα	ἔχω	VB	number=SINGULAR|tense=PR|mood=PARTICIPLE|voice=ACTIVE|gender=FEMININE|case=NOMINATIVE	
τοῖος	τοῖος	ADJ	number=SINGULAR|gender=MASCULINE|case=NOMINATIVE	
ἄῤ	ἄρα		_	
Ἀμφιτρυωνιάδης	Ἀμφιτρυωνιάδας	NN	number=SINGULAR|gender=MASCULINE|case=NOMINATIVE	
ἀκόρητος	ἀκόρητος	ADJ	number=SINGULAR|gender=MASCULINE|case=NOMINATIVE	
ἀυτῆς	ἀυτή	NN	number=SINGULAR|gender=FEMININE|case=GENITIVE	
ἀντίος	ἀντίος	ADJ	number=SINGULAR|gender=MASCULINE|case=NOMINATIVE	
ἔστη	ἵστημι	VB	person=PERSON_3|number=SINGULAR|mood=INDICATIVE|voice=ACTIVE	
Ἄρηος	Ἄρης	NN	number=SINGULAR|gender=MASCULINE|case=GENITIVE	
ἐνὶ	ἐν	PREP	_	
φρεσὶ	φρήν	NN	number=PLURAL|gender=FEMININE|case=DATIVE	
θάρσος	θάρσος	NN	number=SINGULAR|gender=NEUTER|case=ACCUSATIVE	
ἀέξων	ἀέξω	VB	number=SINGULAR|tense=PR|mood=PARTICIPLE|voice=ACTIVE|gender=MASCULINE|case=NOMINATIVE	
ἐσσυμένως	ἐσσύμενος	ADV	_	
πᾶσαι	πᾶς	ADJ	number=PLURAL|gender=FEMININE|case=NOMINATIVE	
δ̓	δέ		_	
ἄῤ	ἄρα		_	
ἵεντο	ἵημι	VB	person=PERSON_3|number=PLURAL|tense=IMP|mood=INDICATIVE	
αἷμα	αἷμα	NN	number=SINGULAR|gender=NEUTER|case=ACCUSATIVE	
μέλαν	μέλας	ADJ	number=SINGULAR|gender=NEUTER|case=ACCUSATIVE	
πιέειν	πίνω	VB	mood=INFINITIVE|voice=ACTIVE	
χθόνα	χθών	NN	number=SINGULAR|gender=FEMININE|case=ACCUSATIVE	
δ̓	δέ		_	
ἔκτυπον	κτυπέω	VB	person=PERSON_3|number=PLURAL|mood=INDICATIVE|voice=ACTIVE	
ὠκέες	ὠκύς	ADJ	number=PLURAL|gender=MASCULINE|case=NOMINATIVE	
ἵπποι	ἵππος	NN	number=PLURAL|gender=MASCULINE|case=NOMINATIVE	
νύσσοντες	νύσσω	VB	number=PLURAL|tense=PR|mood=PARTICIPLE|voice=ACTIVE|gender=MASCULINE|case=NOMINATIVE	
χηλῇσι	χηλή	NN	number=PLURAL|gender=FEMININE|case=DATIVE	
κόνις	κόνις	NN	number=SINGULAR|gender=FEMININE|case=NOMINATIVE	
δέ	δέ		_	
σφ̓	σφεῖς	PRON	number=PLURAL|gender=MASCULINE|case=ACCUSATIVE	
ἀμφιδεδήει	ἀμφιδαίω	VB	person=PERSON_3|number=SINGULAR|tense=PLUSQUAMPERFECT|mood=INDICATIVE|voice=ACTIVE	
κοπτομένη	κόπτω	VB	number=SINGULAR|tense=PR|mood=PARTICIPLE|gender=FEMININE|case=NOMINATIVE	
πλεκτοῖσιν	πλεκτός	ADJ	number=PLURAL|gender=NEUTER|case=DATIVE	
ὑφ̓	ὑπό	PREP	_	
ἅρμασι	ἅρμα	NN	number=PLURAL|gender=NEUTER|case=DATIVE	
καὶ	καί	CONJ	_	
ποσὶν	πούς	NN	number=PLURAL|gender=MASCULINE|case=DATIVE	
ἵππων	ἵππος	NN	number=PLURAL|gender=MASCULINE|case=GENITIVE	
τοὶ	ὁ	PRON	number=PLURAL|gender=MASCULINE|case=NOMINATIVE	
δ̓	δέ		_	
αὖτε	αὖτε	ADV	_	
μάχην	μάχη	NN	number=SINGULAR|gender=FEMININE|case=ACCUSATIVE	
ἔχον	ἔχω	VB	person=PERSON_3|number=PLURAL|tense=IMP|mood=INDICATIVE|voice=ACTIVE	
εὖτ̓	εὖτε	CONJ	_	
ἂν	ἄν		_	
δὴ	δή		_	
Κύκνον	Κύκνος	NN	number=SINGULAR|gender=MASCULINE|case=ACCUSATIVE	
γλυκερῆς	γλυκύς	ADJ	number=SINGULAR|gender=FEMININE|case=GENITIVE	
αἰῶνος	αἰών	NN	number=SINGULAR|gender=FEMININE|case=GENITIVE	
ἀμέρσῃς	ἀμέρδω	VB	person=PERSON_2|number=SINGULAR|mood=SUBJUNCTIVE|voice=ACTIVE	
τὸν	ὁ	PRON	number=SINGULAR|gender=MASCULINE|case=ACCUSATIVE	
μὲν	μέν		_	
ἔπειτ̓	ἔπειτα	ADV	_	
αὐτοῦ	αὐτοῦ	ADV	_	
λιπέειν	λείπω	VB	mood=INFINITIVE|voice=ACTIVE	
καὶ	καί	CONJ	_	
τεύχεα	τεῦχος	NN	number=PLURAL|gender=NEUTER|case=ACCUSATIVE	
τοῖο	ὁ	PRON	number=SINGULAR|gender=MASCULINE|case=GENITIVE	
αὐτὸς	αὐτός	ADJ	number=SINGULAR|gender=MASCULINE|case=NOMINATIVE	
δὲ	δέ		_	
βροτολοιγὸν	βροτολοιγός	ADJ	number=SINGULAR|gender=MASCULINE|case=ACCUSATIVE	
Ἄρην	Ἄρης	NN	number=SINGULAR|gender=MASCULINE|case=ACCUSATIVE	
ἐπιόντα	ἔπειμι	VB	number=SINGULAR|tense=PR|mood=PARTICIPLE|voice=ACTIVE|gender=MASCULINE|case=ACCUSATIVE	
δοκεύσας	δοκεύω	VB	number=SINGULAR|mood=PARTICIPLE|voice=ACTIVE|gender=MASCULINE|case=NOMINATIVE	
ἔνθα	ἔνθα	ADV	_	
κε	ἄν		_	
γυμνωθέντα	γυμνόω	VB	number=SINGULAR|mood=PARTICIPLE|voice=PASSIVE|gender=MASCULINE|case=ACCUSATIVE	
σάκευς	σάκος	NN	number=SINGULAR|gender=NEUTER|case=GENITIVE	
ὕπο	ὑπό	PREP	_	
δαιδαλέοιο	δαιδάλεος	ADJ	number=SINGULAR|gender=NEUTER|case=GENITIVE	
ὀφθαλμοῖσιν	ὀφθαλμός	NN	number=PLURAL|gender=MASCULINE|case=DATIVE	
ἴδῃς	εἶδον	VB	person=PERSON_2|number=SINGULAR|mood=SUBJUNCTIVE|voice=ACTIVE	
ἔνθ̓	ἔνθα	ADV	_	
οὐτάμεν	οὐτάω	VB	mood=INFINITIVE|voice=ACTIVE	
ὀξέι	ὀξύς	ADJ	number=SINGULAR|gender=MASCULINE|case=DATIVE	
χαλκῷ	χαλκός	NN	number=SINGULAR|gender=MASCULINE|case=DATIVE	
ἐν	ἐν	PREP	_	
δ̓	δέ		_	
ἦν	εἰμί	VB	person=PERSON_3|number=SINGULAR|tense=IMP|mood=INDICATIVE|voice=ACTIVE	
ἀθανάτων	ἀθάνατος	ADJ	number=PLURAL|gender=MASCULINE|case=GENITIVE	
ἱερὸς	ἱερός	ADJ	number=SINGULAR|gender=MASCULINE|case=NOMINATIVE	
χορός	χορός	NN	number=SINGULAR|gender=MASCULINE|case=NOMINATIVE	
αὐτὰρ	ἀτάρ	CONJ	_	
ἐπ̓	ἐπί	PREP	_	
ἀκταῖς	ἀκτή	NN	number=PLURAL|gender=FEMININE|case=DATIVE	
ἧστο	ἧμαι	VB	person=PERSON_3|number=SINGULAR|tense=PLUSQUAMPERFECT|mood=INDICATIVE	
ἀνὴρ	ἀνήρ	NN	number=SINGULAR|gender=MASCULINE|case=NOMINATIVE	
ἁλιεὺς	ἁλιεύς	NN	number=SINGULAR|gender=MASCULINE|case=NOMINATIVE	
δεδοκημένος	δεδοκημένος	VB	number=SINGULAR|tense=PERF|mood=PARTICIPLE|gender=MASCULINE|case=NOMINATIVE	
φρῖσσόν	φρίσσω	VB	person=PERSON_3|number=PLURAL|tense=IMP|mood=INDICATIVE|voice=ACTIVE	
γε	γε		_	
μὲν	μέν		_	
αὐχένας	αὐχήν	NN	number=PLURAL|gender=MASCULINE|case=ACCUSATIVE	
ἄμφω	ἄμφω	ADJ	gender=MASCULINE|case=NOMINATIVE	
νόον	νόος	NN	number=SINGULAR|gender=MASCULINE|case=ACCUSATIVE	
γε	γε		_	
μὲν	μέν		_	
οὔ	οὐ	ADV	_	
τις	τις	PRON	number=SINGULAR|gender=FEMININE|case=NOMINATIVE	
ἔριζε	ἐρίζω	VB	person=PERSON_3|number=SINGULAR|tense=IMP|mood=INDICATIVE|voice=ACTIVE	
τάων	ὁ	PRON	number=PLURAL|gender=FEMININE|case=GENITIVE	
ἃς	ὅς	PRON	number=PLURAL|gender=FEMININE|case=ACCUSATIVE	
θνηταὶ	θνητός	ADJ	number=PLURAL|gender=FEMININE|case=NOMINATIVE	
θνητοῖς	θνητός	ADJ	number=PLURAL|gender=MASCULINE|case=DATIVE	
τέκον	τίκτω	VB	person=PERSON_3|number=PLURAL|mood=INDICATIVE|voice=ACTIVE	
εὐνηθεῖσαι	εὐνάω	VB	number=PLURAL|mood=PARTICIPLE|voice=PASSIVE|gender=FEMININE|case=NOMINATIVE	
διὰ	διά	PREP	_	
δὲ	δέ		_	
μέγα	μέγας	ADJ	number=SINGULAR|gender=NEUTER|case=ACCUSATIVE	
σαρκὸς	σάρξ	NN	number=SINGULAR|gender=FEMININE|case=GENITIVE	
ἄραξε	ἀράσσω	VB	person=PERSON_3|number=SINGULAR|mood=INDICATIVE|voice=ACTIVE	
δούρατι	δόρυ	NN	number=SINGULAR|gender=NEUTER|case=DATIVE	
νωμήσας	νωμάω	VB	number=SINGULAR|mood=PARTICIPLE|voice=ACTIVE|gender=MASCULINE|case=NOMINATIVE	
ἐπὶ	ἐπί	PREP	_	
δὲ	δέ		_	
χθονὶ	χθών	NN	number=SINGULAR|gender=FEMININE|case=DATIVE	
κάββαλε	καταβάλλω	VB	person=PERSON_3|number=SINGULAR|mood=INDICATIVE|voice=ACTIVE	
μέσσῃ	μέσος	ADJ	number=SINGULAR|gender=FEMININE|case=DATIVE	
ἤριπε	ἐρείπω	VB	person=PERSON_3|number=SINGULAR|mood=INDICATIVE|voice=ACTIVE	
δ̓	δέ		_	
ὡς	ὡς	ADV	_	
ὅτε	ὅτε	ADV	_	
τις	τις	PRON	number=SINGULAR|gender=FEMININE|case=NOMINATIVE	
δρῦς	δρῦς	NN	number=SINGULAR|gender=FEMININE|case=NOMINATIVE	
ἤριπεν	ἐρείπω	VB	person=PERSON_3|number=SINGULAR|mood=INDICATIVE|voice=ACTIVE	
ἢ	ἤ	CONJ	_	
ὅτε	ὅτε	ADV	_	
πεύκη	πεύκη	NN	number=SINGULAR|gender=FEMININE|case=NOMINATIVE	
ἠλίβατος	ἠλίβατος	ADJ	number=SINGULAR|gender=FEMININE|case=NOMINATIVE	
πληγεῖσα	πλήσσω	VB	number=SINGULAR|mood=PARTICIPLE|voice=PASSIVE|gender=FEMININE|case=NOMINATIVE	
Διὸς	Ζεύς	NN	number=SINGULAR|gender=MASCULINE|case=GENITIVE	
ψολόεντι	ψολόεις	ADJ	number=SINGULAR|gender=MASCULINE|case=DATIVE	
κεραυνῷ	κεραυνός	NN	number=SINGULAR|gender=MASCULINE|case=DATIVE	
δεινὰ	δεινός	ADJ	number=PLURAL|gender=NEUTER|case=ACCUSATIVE	
δ̓	δέ		_	
ἐς	εἰς	PREP	_	
ἀλλήλας	ἀλλήλων	ADJ	number=PLURAL|gender=FEMININE|case=ACCUSATIVE	
δράκον	δέρκομαι	VB	person=PERSON_3|number=PLURAL|mood=INDICATIVE|voice=ACTIVE	
ὄμμασι	ὄμμα	NN	number=PLURAL|gender=NEUTER|case=DATIVE	
θυμήνασαι	θυμαίνω	VB	number=PLURAL|mood=PARTICIPLE|voice=ACTIVE|gender=FEMININE|case=NOMINATIVE	
ἐν	ἐν	ADV	_	
δ̓	δέ		_	
ὄνυχας	ὄνυξ	NN	number=PLURAL|gender=MASCULINE|case=ACCUSATIVE	
χεῖράς	χείρ	NN	number=PLURAL|gender=FEMININE|case=ACCUSATIVE	
τε	τε		_	
θρασείας	θρασύς	ADJ	number=PLURAL|gender=FEMININE|case=ACCUSATIVE	
ἰσώσαντο	ἰσόω	VB	person=PERSON_3|number=PLURAL|mood=INDICATIVE	
τοῦ	ὁ	PRON	number=SINGULAR|gender=MASCULINE|case=GENITIVE	
καὶ	καί	CONJ	_	
ὀδόντων	ὀδούς	NN	number=PLURAL|gender=MASCULINE|case=GENITIVE	
μὲν	μέν		_	
πλῆτο	πίμπλημι	VB	person=PERSON_3|number=SINGULAR|mood=INDICATIVE	
στόμα	στόμα	NN	number=SINGULAR|gender=NEUTER|case=NOMINATIVE	
λευκὰ	λευκός	ADJ	number=PLURAL|gender=NEUTER|case=ACCUSATIVE	
θεόντων	θέω	VB	number=PLURAL|tense=PR|mood=PARTICIPLE|voice=ACTIVE|gender=MASCULINE|case=GENITIVE	
δεινῶν	δεινός	ADJ	number=PLURAL|gender=MASCULINE|case=GENITIVE	
ἀπλήτων	ἄπλατος	ADJ	number=PLURAL|gender=MASCULINE|case=GENITIVE	
ἐπὶ	ἐπί	PREP	_	
δὲ	δέ		_	
βλοσυροῖο	βλοσυρός	ADJ	number=SINGULAR|gender=NEUTER|case=GENITIVE	
μετώπου	μέτωπον	NN	number=SINGULAR|gender=NEUTER|case=GENITIVE	
δεινὴ	δεινός	ADJ	number=SINGULAR|gender=FEMININE|case=NOMINATIVE	
Ἔρις	ἔρις	NN	number=SINGULAR|gender=FEMININE|case=NOMINATIVE	
πεπότητο	ποτάομαι	VB	person=PERSON_3|number=SINGULAR|tense=PLUSQUAMPERFECT|mood=INDICATIVE	
κορύσσουσα	κορύσσω	VB	number=SINGULAR|tense=PR|mood=PARTICIPLE|voice=ACTIVE|gender=FEMININE|case=NOMINATIVE	
κλόνον	κλόνος	NN	number=SINGULAR|gender=MASCULINE|case=ACCUSATIVE	
ἀνδρῶν	ἀνήρ	NN	number=PLURAL|gender=MASCULINE|case=GENITIVE	
σχετλίη	σχέτλιος	ADJ	number=SINGULAR|gender=FEMININE|case=NOMINATIVE	
ἥ	ὅς	PRON	number=SINGULAR|gender=FEMININE|case=NOMINATIVE	
ῥα	ἄρα		_	
νόον	νόος	NN	number=SINGULAR|gender=MASCULINE|case=ACCUSATIVE	
τε	τε		_	
καὶ	καί	CONJ	_	
ἐκ	ἐκ	PREP	_	
φρένας	φρήν	NN	number=PLURAL|gender=FEMININE|case=ACCUSATIVE	
εἵλετο	αἱρέω	VB	person=PERSON_3|number=SINGULAR|mood=INDICATIVE	
φωτῶν	φώς	NN	number=PLURAL|gender=MASCULINE|case=GENITIVE	
πρηνὴς	πρηνής	ADJ	number=SINGULAR|gender=MASCULINE|case=NOMINATIVE	
δ̓	δέ		_	
ἐν	ἐν	PREP	_	
κονίῃσι	κονία	NN	number=PLURAL|gender=FEMININE|case=DATIVE	
χαμαὶ	χαμαί	ADV	_	
πέσεν	πίπτω	VB	person=PERSON_3|number=SINGULAR|mood=INDICATIVE|voice=ACTIVE	
ἔγχεος	ἔγχος	NN	number=SINGULAR|gender=NEUTER|case=GENITIVE	
ὁρμῇ	ὁρμή	NN	number=SINGULAR|gender=FEMININE|case=DATIVE	
εὗρε	εὑρίσκω	VB	person=PERSON_3|number=SINGULAR|mood=INDICATIVE|voice=ACTIVE	
γὰρ	γάρ		_	
ἐν	ἐν	PREP	_	
τεμένει	τέμενος	NN	number=SINGULAR|gender=NEUTER|case=DATIVE	
ἑκατηβόλου	ἑκατηβόλος	ADJ	number=SINGULAR|gender=MASCULINE|case=GENITIVE	
Ἀπόλλωνος	Ἀπόλλων	NN	number=SINGULAR|gender=MASCULINE|case=GENITIVE	
αὐτὸν	αὐτός	ADJ	number=SINGULAR|gender=MASCULINE|case=ACCUSATIVE	
καὶ	καί	CONJ	_	
πατέρα	πατήρ	NN	number=SINGULAR|gender=MASCULINE|case=ACCUSATIVE	
ὅν	ὅς	PRON	number=SINGULAR|gender=MASCULINE|case=ACCUSATIVE	
Ἄρην	Ἄρης	NN	number=SINGULAR|gender=MASCULINE|case=ACCUSATIVE	
ἄατον	ἄατος	ADJ	number=SINGULAR|gender=MASCULINE|case=ACCUSATIVE	
πολέμοιο	πόλεμος	NN	number=SINGULAR|gender=MASCULINE|case=GENITIVE	
τεύχεσι	τεῦχος	NN	number=PLURAL|gender=NEUTER|case=DATIVE	
λαμπομένους	λάμπω	VB	number=PLURAL|tense=PR|mood=PARTICIPLE|gender=MASCULINE|case=ACCUSATIVE	
σέλας	σέλας	NN	number=SINGULAR|gender=NEUTER|case=NOMINATIVE	
ὣς	ὡς	CONJ	_	
πυρὸς	πῦρ	NN	number=SINGULAR|gender=NEUTER|case=GENITIVE	
αἰθομένοιο	αἴθω	VB	number=SINGULAR|tense=PR|mood=PARTICIPLE|gender=NEUTER|case=GENITIVE	
ἑσταότ̓	ἵστημι	VB	tense=PERF|mood=PARTICIPLE|voice=ACTIVE|gender=MASCULINE|case=ACCUSATIVE	
ἐν	ἐν	PREP	_	
δίφρῳ	δίφρος	NN	number=SINGULAR|gender=MASCULINE|case=DATIVE	
χαίρετε	χαίρω	VB	person=PERSON_2|number=PLURAL|tense=PR|mood=IMPERATIVE|voice=ACTIVE	
Λυγκῆος	Λυγκεύς	NN	number=SINGULAR|gender=MASCULINE|case=GENITIVE	
γενεὴ	γενεά	NN	number=SINGULAR|gender=FEMININE|case=VOCATIVE	
τηλεκλειτοῖο	τηλεκλειτός	ADJ	number=SINGULAR|gender=MASCULINE|case=GENITIVE	
ἐν	ἐν	PREP	_	
δ̓	δέ		_	
ἀγορή	ἀγορά	NN	number=SINGULAR|gender=FEMININE|case=NOMINATIVE	
περὶ	περί	PREP	_	
δ̓	δέ		_	
ὄλβος	ὄλβος	NN	number=SINGULAR|gender=MASCULINE|case=NOMINATIVE	
ἀπείριτος	ἀπείριτος	ADJ	number=SINGULAR|gender=MASCULINE|case=NOMINATIVE	
ἐστεφάνωτο	στεφανόω	VB	person=PERSON_3|number=SINGULAR|tense=PLUSQUAMPERFECT|mood=INDICATIVE	
ἀθανάτων	ἀθάνατος	ADJ	number=PLURAL|gender=MASCULINE|case=GENITIVE	
ἐν	ἐν	PREP	_	
ἀγῶνι	ἀγών	NN	number=SINGULAR|gender=MASCULINE|case=DATIVE	
ὣς	ὡς	ADV	_	
οἳ	ὁ	PRON	number=PLURAL|gender=MASCULINE|case=NOMINATIVE	
κεκλήγοντες	κλάζω	VB	number=PLURAL|tense=PERF|mood=PARTICIPLE|voice=ACTIVE|gender=MASCULINE|case=NOMINATIVE	
ἐπ̓	ἐπί	PREP	_	
ἀλλήλοισιν	ἀλλήλων	ADJ	number=PLURAL|gender=MASCULINE|case=DATIVE	
ὄρουσαν	ὀρούω	VB	person=PERSON_3|number=PLURAL|mood=INDICATIVE|voice=ACTIVE	
τῆς	ὁ	PRON	number=SINGULAR|gender=FEMININE|case=GENITIVE	
καὶ	καί	CONJ	_	
ἀπὸ	ἀπό	PREP	_	
κρῆθεν	κράς	NN	number=SINGULAR|case=GENITIVE	
βλεφάρων	βλέφαρον	NN	number=PLURAL|gender=FEMININE|case=GENITIVE	
τ̓	τε		_	
ἄπο	ἀπό	PREP	_	
κυανεάων	κυάνεος	ADJ	number=PLURAL|gender=FEMININE|case=GENITIVE	
τοῖον	τοῖος	ADJ	number=SINGULAR|gender=NEUTER|case=ACCUSATIVE	
ἄηθ̓	ἄημι	VB	person=PERSON_3|number=SINGULAR|tense=IMP|mood=INDICATIVE	
οἶόν	οἶος	ADJ	number=SINGULAR|gender=NEUTER|case=ACCUSATIVE	
τε	τε		_	
πολυχρύσου	πολύχρυσος	ADJ	number=SINGULAR|gender=FEMININE|case=GENITIVE	
Ἀφροδίτης	Ἀφροδίτη	NN	number=SINGULAR|gender=FEMININE|case=GENITIVE	
οἵτινες	ὅστις	PRON	number=PLURAL|gender=MASCULINE|case=NOMINATIVE	
ἀντιβίην	ἀντιβίην	ADV	_	
πόλεμον	πόλεμος	NN	number=SINGULAR|gender=MASCULINE|case=ACCUSATIVE	
Διὸς	Ζεύς	NN	number=SINGULAR|gender=MASCULINE|case=GENITIVE	
υἷι	υἱός	NN	number=SINGULAR|gender=MASCULINE|case=DATIVE	
φέροιεν	φέρω	VB	person=PERSON_3|number=PLURAL|tense=PR|voice=ACTIVE	
αὐτὸς	αὐτός	ADJ	number=SINGULAR|gender=MASCULINE|case=NOMINATIVE	
δὲ	δέ		_	
σπεύδοντι	σπεύδω	VB	number=SINGULAR|tense=PR|mood=PARTICIPLE|voice=ACTIVE|gender=MASCULINE|case=DATIVE	
καὶ	καί	CONJ	_	
ἐρρίγοντι	ῥιγέω	VB	number=SINGULAR|tense=PERF|mood=PARTICIPLE|voice=ACTIVE|gender=MASCULINE|case=DATIVE	
ἐοικὼς	ἔοικα	VB	number=SINGULAR|tense=PERF|mood=PARTICIPLE|voice=ACTIVE|gender=MASCULINE|case=NOMINATIVE	
Περσεὺς	Περσεύς	NN	number=SINGULAR|gender=MASCULINE|case=NOMINATIVE	
Δαναΐδης	Δαναίδαι	NN	number=SINGULAR|gender=MASCULINE|case=NOMINATIVE	
ἐτιταίνετο	τιταίνω	VB	person=PERSON_3|number=SINGULAR|tense=IMP|mood=INDICATIVE	
ἦ	ἦ	ADV	_	
μέν	μέν		_	
οἱ	ἕ	PRON	number=SINGULAR|gender=FEMININE|case=DATIVE	
πατέῤ	πατήρ	NN	number=SINGULAR|gender=MASCULINE|case=ACCUSATIVE	
ἐσθλὸν	ἐσθλός	ADJ	number=SINGULAR|gender=MASCULINE|case=ACCUSATIVE	
ἀπέκτανε	ἀποκτείνω	VB	person=PERSON_3|number=SINGULAR|mood=INDICATIVE|voice=ACTIVE	
ἶφι	ἶφι	ADV	_	
δαμάσσας	δαμάζω	VB	number=SINGULAR|mood=PARTICIPLE|voice=ACTIVE|gender=MASCULINE|case=NOMINATIVE	
χωσάμενος	χώομαι	VB	number=SINGULAR|mood=PARTICIPLE|gender=MASCULINE|case=NOMINATIVE	
περὶ	περί	PREP	_	
βουσί	βοῦς	NN	number=PLURAL|gender=MASCULINE|case=DATIVE	
κοΐλην	κοῖλος	ADJ	number=SINGULAR|gender=FEMININE|case=ACCUSATIVE	
δὲ	δέ		_	
περὶ	περί	PREP	_	
στήθεσσι	στῆθος	NN	number=PLURAL|gender=NEUTER|case=DATIVE	
φαρέτρην	φαρέτρα	NN	number=SINGULAR|gender=FEMININE|case=ACCUSATIVE	
καββάλετ̓	καταβάλλω	VB	person=PERSON_3|number=SINGULAR|mood=INDICATIVE	
ἐξόπιθεν	ἐξόπιθεν	ADV	_	
πολλοὶ	πολύς	ADJ	number=PLURAL|gender=MASCULINE|case=NOMINATIVE	
μὲν	μέν		_	
κέατο	κεῖμαι	VB	person=PERSON_3|number=PLURAL|tense=IMP|mood=INDICATIVE	
πλέονες	πλείων	ADJ	number=PLURAL|gender=MASCULINE|case=NOMINATIVE|degree=COMPARATIVE	
δ̓	δέ		_	
ἔτι	ἔτι	ADV	_	
δῆριν	δῆρις	NN	number=SINGULAR|gender=FEMININE|case=ACCUSATIVE	
ἔχοντες	ἔχω	VB	number=PLURAL|tense=PR|mood=PARTICIPLE|voice=ACTIVE|gender=MASCULINE|case=NOMINATIVE	
μάρνανθ̓	μάρναμαι	VB	person=PERSON_3|number=PLURAL|tense=IMP|mood=INDICATIVE	
δεινὰ	δεινός	ADJ	number=PLURAL|gender=NEUTER|case=ACCUSATIVE	
δ̓	δέ		_	
ὑπόδρα	ὑπόδρα	ADV	_	
ἰδοῦσα	εἶδον	VB	number=SINGULAR|mood=PARTICIPLE|voice=ACTIVE|gender=FEMININE|case=NOMINATIVE	
ἔπεα	ἔπος	NN	number=PLURAL|gender=NEUTER|case=ACCUSATIVE	
πτερόεντα	πτερόεις	ADJ	number=PLURAL|gender=NEUTER|case=ACCUSATIVE	
προσηύδα	προσαυδάω	VB	person=PERSON_3|number=SINGULAR|tense=IMP|mood=INDICATIVE|voice=ACTIVE	
ἥ	ὁ	PRON	number=SINGULAR|gender=FEMININE|case=NOMINATIVE	
ῥα	ἄρα		_	
γυναικῶν	γυνή	NN	number=PLURAL|gender=FEMININE|case=GENITIVE	
φῦλον	φῦλον	NN	number=SINGULAR|gender=NEUTER|case=ACCUSATIVE	
ἐκαίνυτο	καίνυμαι	VB	person=PERSON_3|number=SINGULAR|tense=IMP|mood=INDICATIVE	
θηλυτεράων	θῆλυς	ADJ	number=PLURAL|gender=FEMININE|case=GENITIVE	
εἴδεΐ	εἶδος	NN	number=SINGULAR|gender=NEUTER|case=DATIVE	
τε	τε		_	
μεγέθει	μέγεθος	NN	number=SINGULAR|gender=NEUTER|case=DATIVE	
τε	τε		_	
τόθεν	τόθεν	ADV	_	
αὖτις	αὖθις	ADV	_	
Φίκιον	Φίκιον	NN	number=SINGULAR|gender=MASCULINE|case=ACCUSATIVE	
ἀκρότατον	ἄκρος	ADJ	number=SINGULAR|gender=MASCULINE|case=ACCUSATIVE|degree=SUPERLATIVE	
προσεβήσατο	προσβαίνω	VB	person=PERSON_3|number=SINGULAR|mood=INDICATIVE	
μητίετα	μητίετα	NN	number=SINGULAR|gender=MASCULINE|case=NOMINATIVE	
Ζεύς	Ζεύς	NN	number=SINGULAR|gender=MASCULINE|case=NOMINATIVE	
οὐ	οὐ	ADV	_	
δέ	δέ		_	
νυ	νῦν	ADV	_	
τώ	ὁ	PRON	gender=MASCULINE|case=NOMINATIVE	
γε	γε		_	
οὐδέτεροι	οὐδέτερος	ADJ	number=PLURAL|gender=MASCULINE|case=NOMINATIVE	
τρεέτην	τρέω	VB	person=PERSON_3|tense=IMP|mood=INDICATIVE|voice=ACTIVE	
αὐτὸς	αὐτός	ADJ	number=SINGULAR|gender=MASCULINE|case=NOMINATIVE	
γάρ	γάρ		_	
οἱ	ἕ	PRON	number=SINGULAR|gender=MASCULINE|case=DATIVE	
ἐπῶρσε	ἐπόρνυμι	VB	person=PERSON_3|number=SINGULAR|mood=INDICATIVE|voice=ACTIVE	
βίην	βία	NN	number=SINGULAR|gender=FEMININE|case=ACCUSATIVE	
Ἡρακληείην	Ἡράκλειος	ADJ	number=SINGULAR|gender=FEMININE|case=ACCUSATIVE	
τοῦ	ὁ	PRON	number=SINGULAR|gender=MASCULINE|case=GENITIVE	
δὲ	δέ		_	
τάφον	τάφος	NN	number=SINGULAR|gender=MASCULINE|case=ACCUSATIVE	
καὶ	καί	CONJ	_	
σῆμ̓	σῆμα	NN	number=SINGULAR|gender=NEUTER|case=ACCUSATIVE	
ἀιδὲς	ἀιδής	ADJ	number=SINGULAR|gender=NEUTER|case=ACCUSATIVE	
ποίησεν	ποιέω	VB	person=PERSON_3|number=SINGULAR|mood=INDICATIVE|voice=ACTIVE	
Ἄναυρος	Ἄναυρος	NN	number=SINGULAR|gender=MASCULINE|case=NOMINATIVE	
ὄμβρῳ	ὄμβρος	NN	number=SINGULAR|gender=MASCULINE|case=DATIVE	
χειμερίῳ	χειμέριος	ADJ	number=SINGULAR|gender=MASCULINE|case=DATIVE	
πλήθων	πλήθω	VB	number=SINGULAR|tense=PR|mood=PARTICIPLE|voice=ACTIVE|gender=MASCULINE|case=NOMINATIVE	
μείδησεν	μειδάω	VB	person=PERSON_3|number=SINGULAR|mood=INDICATIVE|voice=ACTIVE	
δὲ	δέ		_	
βίη	βία	NN	number=SINGULAR|gender=FEMININE|case=NOMINATIVE	
Ἡρακληείη	Ἡράκλειος	ADJ	number=SINGULAR|gender=FEMININE|case=NOMINATIVE	
θυμῷ	θυμός	NN	number=SINGULAR|gender=MASCULINE|case=DATIVE	
γηθήσας	γηθέω	VB	number=SINGULAR|mood=PARTICIPLE|voice=ACTIVE|gender=MASCULINE|case=NOMINATIVE	
τοὶ	ὁ	PRON	number=PLURAL|gender=MASCULINE|case=NOMINATIVE	
δ̓	δέ		_	
ἔτι	ἔτι	ADV	_	
μᾶλλον	μᾶλλον	ADV	_	
ἐγειρέσθην	ἐγείρω	VB	person=PERSON_3|tense=IMP|mood=INDICATIVE	
κοτέοντε	κοτέω	VB	tense=PR|mood=PARTICIPLE|voice=ACTIVE|gender=MASCULINE|case=NOMINATIVE	
μάχεσθαι	μάχομαι	VB	tense=PR|mood=INFINITIVE	
ἀμφότεροι	ἀμφότερος	ADJ	number=PLURAL|gender=MASCULINE|case=NOMINATIVE	
χλοῦναί	χλούνης	NN	number=PLURAL|gender=MASCULINE|case=NOMINATIVE	
τε	τε		_	
σύες	ὗς	NN	number=PLURAL|gender=MASCULINE|case=NOMINATIVE	
χαροποί	χαροπός	ADJ	number=PLURAL|gender=MASCULINE|case=NOMINATIVE	
τε	τε		_	
λέοντες	λέων	NN	number=PLURAL|gender=MASCULINE|case=NOMINATIVE	
αἳ	ὁ		number=PLURAL|gender=FEMININE|case=NOMINATIVE	
δὲ	δέ		_	
μετ̓	μετά	PREP	_	
αὐτοὺς	αὐτός	ADJ	number=PLURAL|gender=MASCULINE|case=ACCUSATIVE	
Κῆρες	Κήρ	NN	number=PLURAL|gender=FEMININE|case=NOMINATIVE	
κυάνεαι	κυάνεος	ADJ	number=PLURAL|gender=FEMININE|case=NOMINATIVE	
λευκοὺς	λευκός	ADJ	number=PLURAL|gender=MASCULINE|case=ACCUSATIVE	
ἀραβεῦσαι	ἀραβέω	VB	number=PLURAL|tense=PR|mood=PARTICIPLE|voice=ACTIVE|gender=FEMININE|case=NOMINATIVE	
ὀδόντας	ὀδούς	NN	number=PLURAL|gender=MASCULINE|case=ACCUSATIVE	
δεινωπαὶ	δεινώψ	ADJ	number=PLURAL|gender=FEMININE|case=NOMINATIVE	
βλοσυραί	βλοσυρός	ADJ	number=PLURAL|gender=FEMININE|case=NOMINATIVE	
τε	τε		_	
δαφοιναί	δαφοινός	ADJ	number=PLURAL|gender=FEMININE|case=NOMINATIVE	
τ̓	τε		_	
ἄπληταί	ἄπλατος	ADJ	number=PLURAL|gender=FEMININE|case=NOMINATIVE	
τε	τε		_	
δῆριν	δῆρις	NN	number=SINGULAR|gender=FEMININE|case=ACCUSATIVE	
ἔχον	ἔχω	VB	person=PERSON_3|number=PLURAL|tense=IMP|mood=INDICATIVE|voice=ACTIVE	
περὶ	περί	PREP	_	
πιπτόντων	πίπτω	VB	number=PLURAL|tense=PR|mood=PARTICIPLE|voice=ACTIVE|gender=MASCULINE|case=GENITIVE	
μένει	μένος	NN	number=SINGULAR|gender=NEUTER|case=DATIVE	
δ̓	δέ		_	
ἐχάρασσον	χαράσσω	VB	person=PERSON_3|number=PLURAL|tense=IMP|mood=INDICATIVE|voice=ACTIVE	
ὀδόντας	ὀδούς	NN	number=PLURAL|gender=MASCULINE|case=ACCUSATIVE	
ἄγρια	ἄγριος	ADJ	number=PLURAL|gender=NEUTER|case=ACCUSATIVE	
δερκομένω	δέρκομαι	VB	tense=PR|mood=PARTICIPLE|gender=MASCULINE|case=NOMINATIVE	
ἦ	ἦ	ADV	_	
μὴν	μήν		_	
καὶ	καί	ADV	_	
κρατερός	κρατερός	ADJ	number=SINGULAR|gender=MASCULINE|case=NOMINATIVE	
περ	πέρ		_	
ἐὼν	εἰμί	VB	number=SINGULAR|tense=PR|mood=PARTICIPLE|voice=ACTIVE|gender=MASCULINE|case=NOMINATIVE	
ἄαται	ἄω	VB	person=PERSON_3|number=SINGULAR|tense=PR|mood=INDICATIVE	
πολέμοιο	πόλεμος	NN	number=SINGULAR|gender=MASCULINE|case=GENITIVE	
πατὴρ	πατήρ	NN	number=SINGULAR|gender=MASCULINE|case=NOMINATIVE	
δ̓	δέ		_	
ἀνδρῶν	ἀνήρ	NN	number=PLURAL|gender=MASCULINE|case=GENITIVE	
τε	τε		_	
θεῶν	θεός	NN	number=PLURAL|gender=MASCULINE|case=GENITIVE	
τε	τε		_	
ἄλλην	ἄλλος	ADJ	number=SINGULAR|gender=FEMININE|case=ACCUSATIVE	
μῆτιν	μῆτις	NN	number=SINGULAR|gender=FEMININE|case=ACCUSATIVE	
ὕφαινε	ὑφαίνω	VB	person=PERSON_3|number=SINGULAR|tense=IMP|mood=INDICATIVE|voice=ACTIVE	
μετὰ	μετά	PREP	_	
φρεσίν	φρήν	NN	number=PLURAL|gender=FEMININE|case=DATIVE	
ὥς	ὡς	CONJ	_	
ῥα	ἄρα		_	
θεοῖσιν	θεός	NN	number=PLURAL|gender=MASCULINE|case=DATIVE	
ἀνδράσι	ἀνήρ	NN	number=PLURAL|gender=MASCULINE|case=DATIVE	
τ̓	τε		_	
ἀλφηστῇσιν	ἀλφηστής	NN	number=PLURAL|gender=MASCULINE|case=DATIVE	
ἀρῆς	ἀρή	NN	number=SINGULAR|gender=FEMININE|case=GENITIVE	
ἀλκτῆρα	ἀλκτήρ	NN	number=SINGULAR|gender=MASCULINE|case=ACCUSATIVE	
φυτεύσαι	φυτεύω	VB	person=PERSON_3|number=SINGULAR|voice=ACTIVE	
Κένταυροι	Κένταυρος	NN	number=PLURAL|gender=MASCULINE|case=NOMINATIVE	
δ̓	δέ		_	
ἑτέρωθεν	ἑτέρωθεν	ADV	_	
ἐναντίοι	ἐναντίος	ADJ	number=PLURAL|gender=MASCULINE|case=NOMINATIVE	
ἠγερέθοντο	ἠγερέθομαι	VB	person=PERSON_3|number=PLURAL|tense=IMP|mood=INDICATIVE	
ἀμφὶ	ἀμφί	PREP	_	
μέγαν	μέγας	ADJ	number=SINGULAR|gender=MASCULINE|case=ACCUSATIVE	
Πετραῖον	Πετραῖος	NN	number=SINGULAR|gender=MASCULINE|case=ACCUSATIVE	
ἰδ̓	ἰδέ	CONJ	_	
Ἄσβολον	Ἄσβολος	NN	number=SINGULAR|gender=MASCULINE|case=ACCUSATIVE	
οἰωνιστὴν	οἰωνιστής	NN	number=SINGULAR|gender=MASCULINE|case=ACCUSATIVE	
Ἄρκτον	ἄρκτος	NN	number=SINGULAR|gender=FEMININE|case=ACCUSATIVE	
τ̓	τε		_	
Οὔρειόν	Οὔρειος	NN	number=SINGULAR|gender=MASCULINE|case=ACCUSATIVE	
τε	τε		_	
μελαγχαίτην	μελαγχαίτης	NN	number=SINGULAR|gender=MASCULINE|case=ACCUSATIVE	
τε	τε		_	
Μίμαντα	Μίμας	NN	number=SINGULAR|gender=MASCULINE|case=ACCUSATIVE	
καὶ	καί	CONJ	_	
δύο	δύο	NRL	_	
Πευκεΐδας	Πευκεί		_	
Περιμήδεά	Περιμήδης	NN	number=SINGULAR|gender=MASCULINE|case=ACCUSATIVE	
τε	τε		_	
Δρύαλόν	δρύαλος	NN	number=SINGULAR|gender=MASCULINE|case=ACCUSATIVE	
τε	τε		_	
ἀργύρεοι	ἀργύρεος	ADJ	number=PLURAL|gender=MASCULINE|case=NOMINATIVE	
χρυσέας	χρύσεος	ADJ	number=PLURAL|gender=FEMININE|case=ACCUSATIVE	
ἐλάτας	ἐλάτη	NN	number=PLURAL|gender=FEMININE|case=ACCUSATIVE	
ἐν	ἐν	PREP	_	
χερσὶν	χείρ	NN	number=PLURAL|gender=FEMININE|case=DATIVE	
ἔχοντες	ἔχω	VB	number=PLURAL|tense=PR|mood=PARTICIPLE|voice=ACTIVE|gender=MASCULINE|case=NOMINATIVE	
τὸν	ὁ	PRON	number=SINGULAR|gender=MASCULINE|case=ACCUSATIVE	
μὲν	μέν		_	
χειρότερον	χείρων	ADJ	number=SINGULAR|gender=MASCULINE|case=ACCUSATIVE|degree=COMPARATIVE	
τὸν	ὁ	PRON	number=SINGULAR|gender=MASCULINE|case=ACCUSATIVE	
δ̓	δέ		_	
αὖ	αὖ	ADV	_	
μέγ̓	μέγας	ADJ	number=SINGULAR|gender=NEUTER|case=ACCUSATIVE	
ἀμείνονα	ἀμείνων	ADJ	number=SINGULAR|gender=MASCULINE|case=ACCUSATIVE|degree=COMPARATIVE	
φῶτα	φώς	NN	number=SINGULAR|gender=MASCULINE|case=ACCUSATIVE	
δεινόν	δεινός	ADJ	number=SINGULAR|gender=MASCULINE|case=ACCUSATIVE	
τε	τε		_	
κρατερόν	κρατερός	ADJ	number=SINGULAR|gender=MASCULINE|case=ACCUSATIVE	
τε	τε		_	
βίην	βία	NN	number=SINGULAR|gender=FEMININE|case=ACCUSATIVE	
Ἡρακληείην	Ἡράκλειος	ADJ	number=SINGULAR|gender=FEMININE|case=ACCUSATIVE	
ἐν	ἐν	PREP	_	
δὲ	δέ		_	
λιμὴν	λιμήν	NN	number=SINGULAR|gender=MASCULINE|case=NOMINATIVE	
ἐύορμος	εὔορμος	ADJ	number=SINGULAR|gender=MASCULINE|case=NOMINATIVE	
ἀμαιμακέτοιο	ἀμαιμάκετος	ADJ	number=SINGULAR|gender=FEMININE|case=GENITIVE	
θαλάσσης	θάλασσα	NN	number=SINGULAR|gender=FEMININE|case=GENITIVE	
κυκλοτερὴς	κυκλοτερής	ADJ	number=SINGULAR|gender=MASCULINE|case=NOMINATIVE	
ἐτέτυκτο	τεύχω	VB	person=PERSON_3|number=SINGULAR|tense=PLUSQUAMPERFECT|mood=INDICATIVE	
πανέφθου	πάνεφθος	ADJ	number=SINGULAR|gender=MASCULINE|case=GENITIVE	
κασσιτέροιο	κασσίτερος	NN	number=SINGULAR|gender=MASCULINE|case=GENITIVE	
κλυζομένῳ	κλύζω	VB	number=SINGULAR|tense=PR|mood=PARTICIPLE|gender=MASCULINE|case=DATIVE	
ἴκελος	ἴκελος	ADJ	number=SINGULAR|gender=MASCULINE|case=NOMINATIVE	
οὐ	οὐ	ADV	_	
δ̓	δέ		_	
ὅ	ὁ	PRON	number=SINGULAR|gender=MASCULINE|case=NOMINATIVE	
γ̓	γε		_	
ἐπὶ	ἐπί	PREP	_	
δμῶας	δμώς	NN	number=PLURAL|gender=MASCULINE|case=ACCUSATIVE	
καὶ	καί	CONJ	_	
ποιμένας	ποιμήν	NN	number=PLURAL|gender=MASCULINE|case=ACCUSATIVE	
ἀγροιώτας	ἀγροιώτης	NN	number=PLURAL|gender=MASCULINE|case=ACCUSATIVE	
ὦρτ̓	ὄρνυμι	VB	person=PERSON_3|number=SINGULAR|mood=INDICATIVE	
ἰέναι	εἶμι	VB	tense=PR|mood=INFINITIVE|voice=ACTIVE	
πρίν	πρίν	CONJ	_	
γ̓	γε		_	
ἧς	ἑός	ADJ	number=SINGULAR|gender=FEMININE|case=GENITIVE	
ἀλόχου	ἄλοχος	NN	number=SINGULAR|gender=FEMININE|case=GENITIVE	
ἐπιβήμεναι	ἐπιβαίνω	VB	mood=INFINITIVE|voice=ACTIVE	
εὐνῆς	εὐνή	NN	number=SINGULAR|gender=FEMININE|case=GENITIVE	
πρόσθεν	πρόσθεν	ADV	_	
μὲν	μέν		_	
θάνατόν	θάνατος	NN	number=SINGULAR|gender=MASCULINE|case=ACCUSATIVE	
τ̓	τε		_	
εἶχον	ἔχω	VB	person=PERSON_3|number=PLURAL|tense=IMP|mood=INDICATIVE|voice=ACTIVE	
καὶ	καί	CONJ	_	
δάκρυσι	δάκρυον	NN	number=PLURAL|gender=NEUTER|case=DATIVE	
μῦρον	μύρω	VB	person=PERSON_3|number=PLURAL|tense=IMP|mood=INDICATIVE|voice=ACTIVE	
μέσσοι	μέσος	ADJ	number=PLURAL|gender=MASCULINE|case=NOMINATIVE	
δὲ	δέ		_	
ξεστοί	ξεστός	ADJ	number=PLURAL|gender=MASCULINE|case=NOMINATIVE	
περιμήκεες	περιμήκης	ADJ	number=PLURAL|gender=MASCULINE|case=NOMINATIVE	
αὐτὰρ	ἀτάρ	CONJ	_	
ὄπισθε	ὄπισθεν	ADV	_	
μόρφνοιο	μόρφνος	NN	number=SINGULAR|gender=MASCULINE|case=GENITIVE	
φλεγύαο	φλεγύης	NN	number=SINGULAR|gender=MASCULINE|case=GENITIVE	
καλυπτόμενοι	καλύπτω	VB	number=PLURAL|tense=PR|mood=PARTICIPLE|gender=MASCULINE|case=NOMINATIVE	
πτερύγεσσιν	πτέρυξ	NN	number=PLURAL|gender=FEMININE|case=DATIVE	
τῶν	ὁ	PRON	number=PLURAL|gender=MASCULINE|case=GENITIVE	
καὶ	καί	CONJ	_	
ψυχαὶ	ψυχή	NN	number=PLURAL|gender=FEMININE|case=NOMINATIVE	
μὲν	μέν		_	
χθόνα	χθών	NN	number=SINGULAR|gender=FEMININE|case=ACCUSATIVE	
δύμεναι	δύω	VB	number=PLURAL|mood=PARTICIPLE|gender=FEMININE|case=NOMINATIVE	
Ἄιδος	Ἅιδης	NN	number=SINGULAR|gender=MASCULINE|case=GENITIVE	
εἴσω	εἴσω	PREP	_	
κάκκιον	κατακίω	VB	person=PERSON_3|number=PLURAL|tense=IMP|mood=INDICATIVE|voice=ACTIVE	
ὀστέα	ὀστέον	NN	number=PLURAL|gender=NEUTER|case=NOMINATIVE	
δέ	δέ		_	
σφι	σφεῖς	PRON	number=PLURAL|gender=MASCULINE|case=DATIVE	
περὶ	περί	PREP	_	
ῥινοῖο	ῥινός	NN	number=SINGULAR|gender=FEMININE|case=GENITIVE	
σαπείσης	σήπω	VB	number=SINGULAR|mood=PARTICIPLE|voice=PASSIVE|gender=FEMININE|case=GENITIVE	
Σειρίου	σείριος	NN	number=SINGULAR|gender=MASCULINE|case=GENITIVE	
ἀζαλέοιο	ἀζαλέος	ADJ	number=SINGULAR|gender=MASCULINE|case=GENITIVE	
μελαίνῃ	μέλας	ADJ	number=SINGULAR|gender=FEMININE|case=DATIVE	
πύθεται	πύθω	VB	person=PERSON_3|number=SINGULAR|tense=PR|mood=INDICATIVE|voice=PASSIVE	
αἴῃ	αἶα	NN	number=SINGULAR|gender=FEMININE|case=DATIVE	
μέγα	μέγας	ADJ	number=SINGULAR|gender=NEUTER|case=NOMINATIVE	
γὰρ	γάρ		_	
σθένος	σθένος	NN	number=SINGULAR|gender=NEUTER|case=NOMINATIVE	
ἔμπεσε	ἐμπίπτω	VB	person=PERSON_3|number=SINGULAR|mood=INDICATIVE|voice=ACTIVE	
φωτός	φώς	NN	number=SINGULAR|gender=MASCULINE|case=GENITIVE	
κεχάρητο	χαίρω	VB	person=PERSON_3|number=SINGULAR|tense=PLUSQUAMPERFECT|mood=INDICATIVE	
δὲ	δέ		_	
Κύκνος	Κύκνος	NN	number=SINGULAR|gender=MASCULINE|case=NOMINATIVE	
ἀμύμων	ἀμύμων	ADJ	number=SINGULAR|gender=MASCULINE|case=NOMINATIVE	
ἐλπόμενος	ἔλπω	VB	number=SINGULAR|tense=PR|mood=PARTICIPLE|gender=MASCULINE|case=NOMINATIVE	
Διὸς	Ζεύς	NN	number=SINGULAR|gender=MASCULINE|case=GENITIVE	
υἱὸν	υἱός	NN	number=SINGULAR|gender=MASCULINE|case=ACCUSATIVE	
ἀρήιον	ἄρειος	ADJ	number=SINGULAR|gender=MASCULINE|case=ACCUSATIVE	
ἡνίοχόν	ἡνίοχος	NN	number=SINGULAR|gender=MASCULINE|case=ACCUSATIVE	
τε	τε		_	
χαλκῷ	χαλκός	NN	number=SINGULAR|gender=MASCULINE|case=DATIVE	
δηιώσειν	δηιόω	VB	tense=FUTURE|mood=INFINITIVE|voice=ACTIVE	
καὶ	καί	CONJ	_	
ἀπὸ	ἀπό	PREP	_	
κλυτὰ	κλυτός	ADJ	number=PLURAL|gender=NEUTER|case=ACCUSATIVE	
τεύχεα	τεῦχος	NN	number=PLURAL|gender=NEUTER|case=ACCUSATIVE	
δύσειν	δύω	VB	tense=FUTURE|mood=INFINITIVE|voice=ACTIVE	
τῶν	ὁ		number=PLURAL|gender=MASCULINE|case=GENITIVE	
καὶ	καί	CONJ	_	
ὀδόντων	ὀδούς	NN	number=PLURAL|gender=MASCULINE|case=GENITIVE	
μὲν	μέν		_	
καναχὴ	καναχή	NN	number=SINGULAR|gender=FEMININE|case=NOMINATIVE	
πέλεν	πέλω	VB	person=PERSON_3|number=SINGULAR|tense=IMP|mood=INDICATIVE|voice=ACTIVE	
εὖτε	εὖτε	CONJ	_	
μάχοιτο	μάχομαι	VB	person=PERSON_3|number=SINGULAR|tense=PR	
Ἀμφιτρυωνιάδης	Ἀμφιτρυωνιάδης	NN	number=SINGULAR|gender=MASCULINE|case=NOMINATIVE	
τὰ	ὁ		number=PLURAL|gender=NEUTER|case=NOMINATIVE	
δ̓	δέ		_	
ἐδαίετο	δαίω	VB	person=PERSON_3|number=SINGULAR|tense=IMP|mood=INDICATIVE	
θαυματὰ	θαυματός	ADJ	number=PLURAL|gender=NEUTER|case=NOMINATIVE	
ἔργα	ἔργον	NN	number=PLURAL|gender=NEUTER|case=NOMINATIVE	
ἐν	ἐν	PREP	_	
δ̓	δέ		_	
ἦν	εἰμί	VB	person=PERSON_3|number=SINGULAR|tense=IMP|mood=INDICATIVE|voice=ACTIVE	
ὑσμίνη	ὑσμίνη	NN	number=SINGULAR|gender=FEMININE|case=NOMINATIVE	
Λαπιθάων	Λαπίθαι	NN	number=PLURAL|gender=MASCULINE|case=GENITIVE	
αἰχμητάων	αἰχμητής	NN	number=PLURAL|gender=MASCULINE|case=GENITIVE	
Καινέα	Καινεύς	NN	number=SINGULAR|gender=MASCULINE|case=ACCUSATIVE	
τ̓	τε		_	
ἀμφὶ	ἀμφί	PREP	_	
ἄνακτα	ἄναξ	NN	number=SINGULAR|gender=MASCULINE|case=ACCUSATIVE	
Δρύαντά	Δρύας	NN	number=SINGULAR|gender=MASCULINE|case=ACCUSATIVE	
τε	τε		_	
Πειρίθοόν	Πειρίθοος	NN	number=SINGULAR|gender=MASCULINE|case=ACCUSATIVE	
τε	τε		_	
Ὁπλέα	Ὅπλευς	NN	number=SINGULAR|gender=MASCULINE|case=ACCUSATIVE	
τ̓	τε		_	
Ἐξάδιόν	Ἐξάδιος	NN	number=SINGULAR|gender=MASCULINE|case=ACCUSATIVE	
τε	τε		_	
Φάληρόν	Φάληρος	NN	number=SINGULAR|gender=MASCULINE|case=ACCUSATIVE	
τε	τε		_	
Πρόλοχόν	Πρόλοχος	NN	number=SINGULAR|gender=MASCULINE|case=ACCUSATIVE	
τε	τε		_	
Μόψον	Μόψος	NN	number=SINGULAR|gender=MASCULINE|case=ACCUSATIVE	
τ̓	τε		_	
Ἀμπυκίδην	Ἀμπυκίδης	NN	number=SINGULAR|gender=MASCULINE|case=ACCUSATIVE	
Τιταρήσιον	Τιταρήσιος	NN	number=SINGULAR|gender=MASCULINE|case=ACCUSATIVE	
ὄζον	ὄζος	NN	number=SINGULAR|gender=MASCULINE|case=ACCUSATIVE	
Ἄρηος	Ἄρης	NN	number=SINGULAR|gender=MASCULINE|case=GENITIVE	
Θησέα	Θησεύς	NN	number=SINGULAR|gender=MASCULINE|case=ACCUSATIVE	
τ̓	τε		_	
Αἰγεΐδην	Αἰγείδης	NN	number=SINGULAR|gender=MASCULINE|case=ACCUSATIVE	
ἐπιείκελον	ἐπιείκελος	ADJ	number=SINGULAR|gender=MASCULINE|case=ACCUSATIVE	
ἀθανάτοισιν	ἀθάνατος	ADJ	number=PLURAL|gender=MASCULINE|case=DATIVE	
οἳ	ὁ	PRON	number=PLURAL|gender=MASCULINE|case=NOMINATIVE	
δ̓	δέ		_	
ὀτραλέως	ὀτραλέος	ADV	_	
ἐνόησαν	νοέω	VB	person=PERSON_3|number=PLURAL|mood=INDICATIVE|voice=ACTIVE	
ἐσσυμένως	ἐσσύμενος	ADV	_	
δέ	δέ		_	
οἱ	ἕ	PRON	number=SINGULAR|gender=FEMININE|case=DATIVE	
ἀμφὶ	ἀμφί	PREP	_	
μάχην	μάχη	NN	number=SINGULAR|gender=FEMININE|case=ACCUSATIVE	
δριμεῖαν	δριμύς	ADJ	number=SINGULAR|gender=FEMININE|case=ACCUSATIVE	
ἔθεντο	τίθημι	VB	person=PERSON_3|number=PLURAL|mood=INDICATIVE	
ὣς	ὡς	ADV	_	
ἔφατ̓	φημί	VB	person=PERSON_3|number=SINGULAR|tense=IMP|mood=INDICATIVE	
δριμὺ	δριμύς	ADJ	number=SINGULAR|gender=NEUTER|case=NOMINATIVE	
δ̓	δέ		_	
Ἄρην	Ἄρης	NN	number=SINGULAR|gender=MASCULINE|case=ACCUSATIVE	
ἄχος	ἄχος	NN	number=SINGULAR|gender=NEUTER|case=NOMINATIVE	
εἷλε	αἱρέω	VB	person=PERSON_3|number=SINGULAR|mood=INDICATIVE|voice=ACTIVE	
ἔνθ̓	ἔνθα	ADV	_	
ὅ	ὁ	PRON	number=SINGULAR|gender=MASCULINE|case=NOMINATIVE	
γε	γε		_	
δώματ̓	δῶμα	NN	number=PLURAL|gender=NEUTER|case=ACCUSATIVE	
ἔναιε	ναίω	VB	person=PERSON_3|number=SINGULAR|tense=IMP|mood=INDICATIVE|voice=ACTIVE	
σὺν	σύν	PREP	_	
αἰδοίῃ	αἰδοῖος	ADJ	number=SINGULAR|gender=FEMININE|case=DATIVE	
παρακοίτι	παράκοιτις	NN	number=SINGULAR|gender=FEMININE|case=DATIVE	
νόσφιν	νόσφι	ADV	_	
ἄτερ	ἄτερ	PREP	_	
φιλότητος	φιλότης	NN	number=SINGULAR|gender=FEMININE|case=GENITIVE	
ἐφιμέρου	ἐφίμερος	ADJ	number=SINGULAR|gender=FEMININE|case=GENITIVE	
οὐ	οὐ	ADV	_	
δέ	δέ		_	
οἱ	ἕ	PRON	number=SINGULAR|gender=MASCULINE|case=DATIVE	
ἦεν	εἰμί	VB	person=PERSON_3|number=SINGULAR|tense=IMP|mood=INDICATIVE|voice=ACTIVE	
πρὶν	πρίν	ADV	_	
λεχέων	λέχος	NN	number=PLURAL|gender=NEUTER|case=GENITIVE	
ἐπιβῆναι	ἐπιβαίνω	VB	mood=INFINITIVE|voice=ACTIVE	
ἐυσφύρου	εὔσφυρος	ADJ	number=SINGULAR|gender=FEMININE|case=GENITIVE	
Ἠλεκτρυώνης	Ηλεκτρύωνος	ADJ	number=SINGULAR|gender=FEMININE|case=GENITIVE	
πρίν	πρίν	CONJ	_	
γε	γε		_	
φόνον	φόνος	NN	number=SINGULAR|gender=MASCULINE|case=ACCUSATIVE	
τίσαιτο	τίνω	VB	person=PERSON_3|number=SINGULAR	
κασιγνήτων	κασίγνητος	NN	number=PLURAL|gender=MASCULINE|case=GENITIVE	
μεγαθύμων	μεγάθυμος	ADJ	number=PLURAL|gender=MASCULINE|case=GENITIVE	
ἧς	ὅς	PRON	number=SINGULAR|gender=FEMININE|case=GENITIVE	
ἀλόχου	ἄλοχος	NN	number=SINGULAR|gender=FEMININE|case=GENITIVE	
μαλερῷ	μαλερός	ADJ	number=SINGULAR|gender=NEUTER|case=DATIVE	
δὲ	δέ		_	
καταφλέξαι	καταφλέγω	VB	person=PERSON_3|number=SINGULAR|voice=ACTIVE	
πυρὶ	πῦρ	NN	number=SINGULAR|gender=NEUTER|case=DATIVE	
κώμας	κώμη	NN	number=PLURAL|gender=FEMININE|case=ACCUSATIVE	
ἀνδρῶν	ἀνήρ	NN	number=PLURAL|gender=MASCULINE|case=GENITIVE	
ἡρώων	ἥρως	NN	number=PLURAL|gender=MASCULINE|case=GENITIVE	
Ταφίων	τάφιος	ADJ	number=PLURAL|gender=MASCULINE|case=GENITIVE	
ἰδὲ	ἰδέ	CONJ	_	
Τηλεβοάων	τηλεβόας	NN	number=PLURAL|gender=MASCULINE|case=GENITIVE	
ἐπὶ	ἐπί	PREP	_	
δὲ	δέ		_	
δεινοῖσι	δεινός	ADJ	number=PLURAL|gender=NEUTER|case=DATIVE	
καρήνοις	κάρηνον	NN	number=PLURAL|gender=NEUTER|case=DATIVE	
Γοργείοις	Γόργειος	ADJ	number=PLURAL|gender=NEUTER|case=DATIVE	
ἐδονεῖτο	δονέω	VB	person=PERSON_3|number=SINGULAR|tense=IMP|mood=INDICATIVE	
μέγας	μέγας	ADJ	number=SINGULAR|gender=MASCULINE|case=NOMINATIVE	
Φόβος	φόβος	NN	number=SINGULAR|gender=MASCULINE|case=NOMINATIVE	
εἶχε	ἔχω	VB	person=PERSON_3|number=SINGULAR|tense=IMP|mood=INDICATIVE|voice=ACTIVE	
δὲ	δέ		_	
χερσὶν	χείρ	NN	number=PLURAL|gender=FEMININE|case=DATIVE	
ἰχθύσιν	ἰχθύς	NN	number=PLURAL|gender=MASCULINE|case=DATIVE	
ἀμφίβληστρον	ἀμφίβληστρον	NN	number=SINGULAR|gender=NEUTER|case=ACCUSATIVE	
ἀπορρίψοντι	ἀπορρίπτω	VB	number=SINGULAR|tense=FUTURE|mood=PARTICIPLE|voice=ACTIVE|gender=MASCULINE|case=DATIVE	
ἐοικώς	ἔοικα	VB	number=SINGULAR|tense=PERF|mood=PARTICIPLE|voice=ACTIVE|gender=MASCULINE|case=NOMINATIVE	
ἅρματα	ἅρμα	NN	number=PLURAL|gender=NEUTER|case=NOMINATIVE	
δ̓	δέ		_	
εὐποίητα	εὐποίητος	ADJ	number=PLURAL|gender=NEUTER|case=NOMINATIVE	
καὶ	καί	CONJ	_	
ἄντυγες	ἄντυξ	NN	number=PLURAL|gender=FEMININE|case=NOMINATIVE	
ἀμφαράβιζον	ἀμφαραβέω	VB	person=PERSON_3|number=PLURAL|tense=IMP|mood=INDICATIVE|voice=ACTIVE	
ἵππων	ἵππος	NN	number=PLURAL|gender=MASCULINE|case=GENITIVE	
ἱεμένων	ἵημι	VB	number=PLURAL|tense=PR|mood=PARTICIPLE|gender=MASCULINE|case=GENITIVE	
οἷος	οἷος	ADJ	number=SINGULAR|gender=MASCULINE|case=NOMINATIVE	
δ̓	δέ		_	
ἐν	ἐν	PREP	_	
βήσσῃς	βῆσσα	NN	number=PLURAL|gender=FEMININE|case=DATIVE	
ὄρεος	ὄρος	NN	number=SINGULAR|gender=NEUTER|case=GENITIVE	
χαλεπὸς	χαλεπός	ADJ	number=SINGULAR|gender=MASCULINE|case=NOMINATIVE	
προϊδέσθαι	προεῖδον	VB	mood=INFINITIVE	
κάπρος	κάπρος	NN	number=SINGULAR|gender=MASCULINE|case=NOMINATIVE	
χαυλιόδων	χαυλιόδους	ADJ	number=SINGULAR|gender=MASCULINE|case=NOMINATIVE	
φρονέει	φρονέω	VB	person=PERSON_3|number=SINGULAR|tense=PR|mood=INDICATIVE|voice=ACTIVE	
θυμῷ	θυμός	NN	number=SINGULAR|gender=MASCULINE|case=DATIVE	
μαχέσασθαι	μάχομαι	VB	mood=INFINITIVE	
ἀνδράσι	ἀνήρ	NN	number=PLURAL|gender=MASCULINE|case=DATIVE	
θηρευτῇς	θηρευτής	NN	number=PLURAL|gender=MASCULINE|case=DATIVE	
θήγει	θήγω	VB	person=PERSON_3|number=SINGULAR|tense=PR|mood=INDICATIVE|voice=ACTIVE	
δέ	δέ		_	
τε	τε		_	
λευκὸν	λευκός	ADJ	number=SINGULAR|gender=MASCULINE|case=ACCUSATIVE	
ὀδόντα	ὀδούς	NN	number=SINGULAR|gender=MASCULINE|case=ACCUSATIVE	
δοχμωθείς	δοχμόομαι	VB	number=SINGULAR|mood=PARTICIPLE|voice=PASSIVE|gender=MASCULINE|case=NOMINATIVE	
ἀφρὸς	ἀφρός	NN	number=SINGULAR|gender=MASCULINE|case=NOMINATIVE	
δὲ	δέ		_	
περὶ	περί	PREP	_	
στόμα	στόμα	NN	number=SINGULAR|gender=NEUTER|case=ACCUSATIVE	
μαστιχόωντι	μαστιχάω	VB	number=SINGULAR|tense=PR|mood=PARTICIPLE|voice=ACTIVE|gender=MASCULINE|case=DATIVE	
λείβεται	λείβω	VB	person=PERSON_3|number=SINGULAR|tense=PR|mood=INDICATIVE	
ὄσσε	ὄσσε	NN	gender=NEUTER|case=NOMINATIVE	
δέ	δέ		_	
οἱ	ἕ	PRON	number=SINGULAR|gender=MASCULINE|case=DATIVE	
πυρὶ	πῦρ	NN	number=SINGULAR|gender=NEUTER|case=DATIVE	
λαμπετόωντι	λαμπετάω	VB	number=SINGULAR|tense=PR|mood=PARTICIPLE|voice=ACTIVE|gender=NEUTER|case=DATIVE	
ἔικτον	ἔοικα	VB	person=PERSON_3|tense=PERF|mood=INDICATIVE|voice=ACTIVE	
ὀρθὰς	ὀρθός	ADJ	number=PLURAL|gender=FEMININE|case=ACCUSATIVE	
δ̓	δέ		_	
ἐν	ἐν	PREP	_	
λοφιῇ	λοφιά	NN	number=SINGULAR|gender=FEMININE|case=DATIVE	
φρίσσει	φρίσσω	VB	person=PERSON_3|number=SINGULAR|tense=PR|mood=INDICATIVE|voice=ACTIVE	
τρίχας	θρίξ	NN	number=PLURAL|gender=FEMININE|case=ACCUSATIVE	
ἀμφί	ἀμφί	PREP	_	
τε	τε		_	
δειρήν	δειρή	NN	number=SINGULAR|gender=FEMININE|case=ACCUSATIVE	
αἳ	ὁ	PRON	number=PLURAL|gender=FEMININE|case=NOMINATIVE	
δὲ	δέ		_	
φρένας	φρήν	NN	number=PLURAL|gender=FEMININE|case=ACCUSATIVE	
εὖτ̓	εὖτε	CONJ	_	
ἀρέσαντο	ἀρέσκω	VB	person=PERSON_3|number=PLURAL|mood=INDICATIVE	
αἵματος	αἷμα	NN	number=SINGULAR|gender=NEUTER|case=GENITIVE	
ἀνδρομέου	ἀνδρόμεος	ADJ	number=SINGULAR|gender=NEUTER|case=GENITIVE	
τὸν	ὁ	PRON	number=SINGULAR|gender=MASCULINE|case=ACCUSATIVE	
μὲν	μέν		_	
ῥίπτασκον	ῥίπτω	VB	person=PERSON_3|number=PLURAL|tense=IMP|mood=INDICATIVE|voice=ACTIVE	
ὀπίσσω	ὀπίσω	ADV	_	
ἂψ	ἄψ	ADV	_	
δ̓	δέ		_	
ὅμαδον	ὅμαδος	NN	number=SINGULAR|gender=MASCULINE|case=ACCUSATIVE	
καὶ	καί	CONJ	_	
μῶλον	μῶλος	NN	number=SINGULAR|gender=MASCULINE|case=ACCUSATIVE	
ἐθύνεον	θυνέω	VB	person=PERSON_3|number=PLURAL|tense=IMP|mood=INDICATIVE|voice=ACTIVE	
αὖτις	αὖθις	ADV	_	
ἰοῦσαι	εἶμι	VB	number=PLURAL|tense=PR|mood=PARTICIPLE|voice=ACTIVE|gender=FEMININE|case=NOMINATIVE	
ζῶε	ζώω	VB	person=PERSON_3|number=SINGULAR|tense=IMP|mood=INDICATIVE|voice=ACTIVE	
δ̓	δέ		_	
ἀγαλλόμενος	ἀγάλλω	VB	number=SINGULAR|tense=PR|mood=PARTICIPLE|gender=MASCULINE|case=NOMINATIVE	
σὺν	σύν	PREP	_	
ἐυσφύρῳ	εὔσφυρος	ADJ	number=SINGULAR|gender=FEMININE|case=DATIVE	
Ἠλεκτρυώνῃ	Ἠλεκτρυῶνος	ADJ	number=SINGULAR|gender=FEMININE|case=DATIVE	
ᾗ	ἑός	ADJ	number=SINGULAR|gender=FEMININE|case=DATIVE	
ἀλόχῳ	ἄλοχος	NN	number=SINGULAR|gender=FEMININE|case=DATIVE	
τὼς	τώς	ADV	_	
γάρ	γάρ		_	
μιν	μιν	PRON	number=SINGULAR|gender=MASCULINE|case=ACCUSATIVE	
παλάμαις	παλάμη	NN	number=PLURAL|gender=FEMININE|case=DATIVE	
τεῦξεν	τεύχω	VB	person=PERSON_3|number=SINGULAR|mood=INDICATIVE|voice=ACTIVE	
κλυτὸς	κλυτός	ADJ	number=SINGULAR|gender=MASCULINE|case=NOMINATIVE	
Ἀμφιγυήεις	ἀμφιγύεις	ADJ	number=SINGULAR|gender=MASCULINE|case=NOMINATIVE	
χρύσεον	χρύσεος	ADJ	number=SINGULAR|gender=MASCULINE|case=ACCUSATIVE	
αἶψα	αἶψα	ADV	_	
δ̓	δέ		_	
ἔπειτα	ἔπειτα	ADV	_	
ἵππους	ἵππος	NN	number=PLURAL|gender=MASCULINE|case=ACCUSATIVE	
μαστιέτην	μαστίω	VB	person=PERSON_3|tense=IMP|mood=INDICATIVE|voice=ACTIVE	
τὸν	ὁ	PRON	number=SINGULAR|gender=MASCULINE|case=ACCUSATIVE	
μὲν	μέν		_	
ὑποδμηθεῖσα	ὑποδαμνάω	VB	number=SINGULAR|mood=PARTICIPLE|voice=PASSIVE|gender=FEMININE|case=NOMINATIVE	
κελαινεφέι	κελαινεφής	ADJ	number=SINGULAR|gender=MASCULINE|case=DATIVE	
Κρονίωνι	Κρονίων	NN	number=SINGULAR|gender=MASCULINE|case=DATIVE	
τὸν	ὁ		number=SINGULAR|gender=MASCULINE|case=ACCUSATIVE	
δ̓	δέ		_	
ἄρα	ἄρα		_	
Ἰφικλῆα	Ἰφικλέης	NN	number=SINGULAR|gender=MASCULINE|case=ACCUSATIVE	
δορυσσόῳ	δορυσσόος	ADJ	number=SINGULAR|gender=MASCULINE|case=DATIVE	
Ἀμφιτρύωνι	Ἀμφιτρύων	NN	number=SINGULAR|gender=MASCULINE|case=DATIVE	
κεκριμένην	κρίνω	VB	number=SINGULAR|tense=PERF|mood=PARTICIPLE|gender=FEMININE|case=ACCUSATIVE	
γενεήν	γενεά	NN	number=SINGULAR|gender=FEMININE|case=ACCUSATIVE	
Ὣς	ὡς	ADV	_	
φάτο	φημί	VB	person=PERSON_3|number=SINGULAR|mood=INDICATIVE	
ὡς	ὡς	ADV	_	
δ̓	δέ		_	
ὅτ̓	ὅτε	ADV	_	
ἀπὸ	ἀπό	PREP	_	
μεγάλου	μέγας	ADJ	number=SINGULAR|gender=MASCULINE|case=GENITIVE	
πέτρη	πέτρα	NN	number=SINGULAR|gender=FEMININE|case=NOMINATIVE	
πρηῶνος	πρηών	NN	number=SINGULAR|gender=MASCULINE|case=GENITIVE	
ὀρούσῃ	ὀρούω	VB	person=PERSON_3|number=SINGULAR|mood=SUBJUNCTIVE|voice=ACTIVE	
μακρὰ	μακρός	ADJ	number=PLURAL|gender=NEUTER|case=ACCUSATIVE	
δ̓	δέ		_	
ἐπιθρῴσκουσα	θρῴσκω	VB	number=SINGULAR|tense=PR|mood=PARTICIPLE|voice=ACTIVE|gender=FEMININE|case=NOMINATIVE	
κυλίνδεται	κυλίνδω	VB	person=PERSON_3|number=SINGULAR|tense=PR|mood=INDICATIVE	
ἣ	ὁ	PRON	number=SINGULAR|gender=FEMININE|case=NOMINATIVE	
δέ	δέ		_	
τε	τε		_	
ἠχῇ	ἠχή	NN	number=SINGULAR|gender=FEMININE|case=DATIVE	
ἔρχεται	ἔρχομαι	VB	person=PERSON_3|number=SINGULAR|tense=PR|mood=INDICATIVE	
ἐμμεμαυῖα	ἐμμεμαώς	VB	number=SINGULAR|tense=PERF|mood=PARTICIPLE|voice=ACTIVE|gender=FEMININE|case=NOMINATIVE	
πάγος	πάγος	NN	number=SINGULAR|gender=MASCULINE|case=NOMINATIVE	
δέ	δέ		_	
οἱ	ἕ	PRON	number=SINGULAR|gender=FEMININE|case=DATIVE	
ἀντεβόλησεν	ἀντιβολέω	VB	person=PERSON_3|number=SINGULAR|mood=INDICATIVE|voice=ACTIVE	
ὑψηλός	ὑψηλός	ADJ	number=SINGULAR|gender=MASCULINE|case=NOMINATIVE	
ἐρυσσάμενος	ἐρύω	VB	number=SINGULAR|mood=PARTICIPLE|gender=MASCULINE|case=NOMINATIVE	
δ̓	δέ		_	
ἄορ	ἄορ	NN	number=SINGULAR|gender=NEUTER|case=ACCUSATIVE	
ὀξὺ	ὀξύς	ADJ	number=SINGULAR|gender=NEUTER|case=ACCUSATIVE	
ἔσσυτ̓	σεύω	VB	person=PERSON_3|number=SINGULAR|tense=IMP|mood=INDICATIVE	
ἐφ̓	ἐπί	PREP	_	
Ἡρακλέα	Ἡρακλέης	NN	number=SINGULAR|gender=MASCULINE|case=ACCUSATIVE	
κρατερόφρονα	κρατερόφρων	ADJ	number=SINGULAR|gender=MASCULINE|case=ACCUSATIVE	
τῶν	ὁ	PRON	number=PLURAL|gender=MASCULINE|case=GENITIVE	
καὶ	καί	CONJ	_	
ὁμιληδὸν	ὁμιληδόν	ADV	_	
στίχες	στίξ	NN	number=PLURAL|gender=FEMININE|case=NOMINATIVE	
ἤισαν	εἶμι	VB	person=PERSON_3|number=PLURAL|tense=IMP|mood=INDICATIVE|voice=ACTIVE	
τὸ	ὁ	PRON	number=SINGULAR|gender=NEUTER|case=ACCUSATIVE	
μὲν	μέν		_	
Διὸς	Ζεύς	NN	number=SINGULAR|gender=MASCULINE|case=GENITIVE	
ἄλκιμος	ἄλκιμος	ADJ	number=SINGULAR|gender=MASCULINE|case=NOMINATIVE	
υἱὸς	υἱός	NN	number=SINGULAR|gender=MASCULINE|case=NOMINATIVE	
πάλλεν	πάλλω	VB	person=PERSON_3|number=SINGULAR|tense=IMP|mood=INDICATIVE|voice=ACTIVE	
ἐπικρατέως	ἐπικρατής	ADV	_	
κύκνον	Κύκνος	NN	number=SINGULAR|gender=MASCULINE|case=ACCUSATIVE	
δ̓	δέ		_	
αὖ	αὖ	ADV	_	
Κῆυξ	Κῆυξ	NN	number=SINGULAR|gender=MASCULINE|case=NOMINATIVE	
θάπτεν	θάπτω	VB	person=PERSON_3|number=SINGULAR|tense=IMP|mood=INDICATIVE|voice=ACTIVE	
καὶ	καί	CONJ	_	
λαὸς	λαός	NN	number=SINGULAR|gender=MASCULINE|case=NOMINATIVE	
ἀπείρων	ἀπείρων	ADJ	number=SINGULAR|gender=MASCULINE|case=NOMINATIVE	
οἵ	ὅς	PRON	number=PLURAL|gender=MASCULINE|case=NOMINATIVE	
ῥ̓	ἄρα		_	
ἐγγὺς	ἐγγύς	ADV	_	
ναῖον	ναίω	VB	person=PERSON_3|number=PLURAL|tense=IMP|mood=INDICATIVE|voice=ACTIVE	
πόλιας	πόλις	NN	number=PLURAL|gender=FEMININE|case=ACCUSATIVE	
κλειτοῦ	κλειτός	ADJ	number=SINGULAR|gender=MASCULINE|case=GENITIVE	
βασιλῆος	βασιλεύς	NN	number=SINGULAR|gender=MASCULINE|case=GENITIVE	
Ἄνθην	Ἄνθη	NN	number=SINGULAR|gender=FEMININE|case=ACCUSATIVE	
Μυρμιδόνων	Μυρμιδόνες	NN	number=PLURAL|gender=MASCULINE|case=GENITIVE	
τε	τε		_	
πόλιν	πόλις	NN	number=SINGULAR|gender=FEMININE|case=ACCUSATIVE	
κλειτήν	κλειτός	ADJ	number=SINGULAR|gender=FEMININE|case=ACCUSATIVE	
τ̓	τε		_	
Ἰαωλκὸν	Ἰαωλκός	NN	number=SINGULAR|gender=FEMININE|case=ACCUSATIVE	
Ἄρνην	Ἄρνη	NN	number=SINGULAR|gender=FEMININE|case=ACCUSATIVE	
τ̓	τε		_	
ἠδ̓	ἠδέ	CONJ	_	
Ἑλίκην	Ἑλίκη	NN	number=SINGULAR|gender=FEMININE|case=ACCUSATIVE	
ἀλλ̓	ἀλλά	ADV	_	
ἄγε	ἄγε	ADV	_	
δύσεο	δύω	VB	person=PERSON_2|number=SINGULAR|mood=IMPERATIVE	
τεύχἐ	τεῦχος	NN	number=PLURAL|gender=NEUTER|case=ACCUSATIVE	
ἀρήια	ἄρειος	ADJ	number=PLURAL|gender=NEUTER|case=ACCUSATIVE	
ὄφρα	ὄφρα	CONJ	_	
τάχιστα	ταχύς	ADJ	number=PLURAL|gender=NEUTER|case=ACCUSATIVE	
δίφρους	δίφρος	NN	number=PLURAL|gender=MASCULINE|case=ACCUSATIVE	
ἐμπελάσαντες	ἐμπελάζω	VB	number=PLURAL|mood=PARTICIPLE|voice=ACTIVE|gender=MASCULINE|case=NOMINATIVE	
Ἄρηός	Ἄρης	NN	number=SINGULAR|gender=MASCULINE|case=GENITIVE	
θ̓	τε		_	
ἡμέτερόν	ἡμέτερος	ADJ	number=SINGULAR|gender=MASCULINE|case=ACCUSATIVE	
τε	τε		_	
μαρνώμεσθ̓	μάρναμαι	VB	person=PERSON_1|number=PLURAL|tense=PR|mood=SUBJUNCTIVE	
ἐπεὶ	ἐπεί	CONJ	_	
οὔ	οὐ	ADV	_	
τοι	τοι		_	
ἀτάρβητον	ἀτάρβητος	ADJ	number=SINGULAR|gender=MASCULINE|case=ACCUSATIVE	
Διὸς	Ζεύς	NN	number=SINGULAR|gender=MASCULINE|case=GENITIVE	
υἱὸν	υἱός	NN	number=SINGULAR|gender=MASCULINE|case=ACCUSATIVE	
οὐ	δέ		_	
δ̓	δέ		_	
Ἰφικλεΐδην	Ἰφιλεί		_	
δειδίξεται	δειδίσσομαι	VB	person=PERSON_3|number=SINGULAR|tense=FUTURE|mood=INDICATIVE	
ἀλλά	ἀλλά	CONJ	_	
μιν	μιν	PRON	number=SINGULAR|gender=MASCULINE|case=ACCUSATIVE	
οἴω	οἴομαι	VB	person=PERSON_1|number=SINGULAR|tense=PR|mood=INDICATIVE|voice=ACTIVE	
φεύξεσθαι	φεύγω	VB	tense=FUTURE|mood=INFINITIVE	
δύο	δύο	NRL	_	
παῖδας	παῖς	NN	number=PLURAL|gender=MASCULINE|case=ACCUSATIVE	
ἀμύμονος	ἀμύμων	ADJ	number=SINGULAR|gender=MASCULINE|case=GENITIVE	
Ἀλκεΐδαο	Ἀλκεί		_	
οἳ	ὁ	PRON	number=PLURAL|gender=MASCULINE|case=NOMINATIVE	
δή	δή		_	
σφι	σφεῖς	PRON	number=PLURAL|gender=MASCULINE|case=DATIVE	
σχεδόν	σχεδόν	ADV	_	
εἰσι	εἰμί	VB	person=PERSON_3|number=PLURAL|tense=PR|mood=INDICATIVE|voice=ACTIVE	
λιλαιόμενοι	λιλαίομαι	VB	number=PLURAL|tense=PR|mood=PARTICIPLE|gender=MASCULINE|case=NOMINATIVE	
πολέμοιο	πόλεμος	NN	number=SINGULAR|gender=MASCULINE|case=GENITIVE	
φυλόπιδα	φύλοπις	NN	number=SINGULAR|gender=FEMININE|case=ACCUSATIVE	
στῆσαι	ἵστημι	VB	mood=INFINITIVE|voice=ACTIVE	
τά	ὁ	PRON	number=PLURAL|gender=NEUTER|case=NOMINATIVE	
σφιν	σφεῖς	PRON	number=PLURAL|gender=MASCULINE|case=DATIVE	
πολὺ	πολύς	ADJ	number=SINGULAR|gender=NEUTER|case=ACCUSATIVE	
φίλτερα	φίλτερος	ADJ	number=PLURAL|gender=NEUTER|case=NOMINATIVE	
θοίνης	θοίνη	NN	number=SINGULAR|gender=FEMININE|case=GENITIVE	
παρὰ	παρά	PREP	_	
δ̓	δέ		_	
εὔπυργος	εὔπυργος	ADJ	number=SINGULAR|gender=FEMININE|case=NOMINATIVE	
πόλις	πόλις	NN	number=SINGULAR|gender=FEMININE|case=NOMINATIVE	
ἀνδρῶν	ἀνήρ	NN	number=PLURAL|gender=MASCULINE|case=GENITIVE	
θύσανοι	θύσανος	NN	number=PLURAL|gender=MASCULINE|case=NOMINATIVE	
δὲ	δέ		_	
κατῃωρεῦντο	καταιωρέομαι	VB	person=PERSON_3|number=PLURAL|tense=IMP|mood=INDICATIVE	
φαεινοὶ	φαεινός	ADJ	number=PLURAL|gender=MASCULINE|case=NOMINATIVE	
χρύσειοι	χρύσεος	ADJ	number=PLURAL|gender=MASCULINE|case=NOMINATIVE	
μέγα	μέγας	ADJ	number=SINGULAR|gender=NEUTER|case=ACCUSATIVE	
δὲ	δέ		_	
φρεσὶ	φρήν	NN	number=PLURAL|gender=FEMININE|case=DATIVE	
θάρσος	θάρσος	NN	number=SINGULAR|gender=NEUTER|case=ACCUSATIVE	
ἀέξων	ἀέξω	VB	number=SINGULAR|tense=PR|mood=PARTICIPLE|voice=ACTIVE|gender=MASCULINE|case=NOMINATIVE	
ἰθὺς	ἰθύς	ADV	_	
ἔχειν	ἔχω	VB	tense=PR|mood=INFINITIVE|voice=ACTIVE	
θοὸν	θοός	ADJ	number=SINGULAR|gender=NEUTER|case=ACCUSATIVE	
ἅρμα	ἅρμα	NN	number=SINGULAR|gender=NEUTER|case=ACCUSATIVE	
καὶ	καί	CONJ	_	
ὠκυπόδων	ὠκύπους	NN	number=PLURAL|gender=MASCULINE|case=GENITIVE	
σθένος	σθένος	NN	number=SINGULAR|gender=NEUTER|case=ACCUSATIVE	
ἵππων	ἵππος	NN	number=PLURAL|gender=MASCULINE|case=GENITIVE	
μηδὲν	μηδείς	NN	number=SINGULAR|gender=NEUTER|case=ACCUSATIVE	
ὑποδδείσας	ὑποδείδω	VB	number=SINGULAR|mood=PARTICIPLE|voice=ACTIVE|gender=MASCULINE|case=NOMINATIVE	
κτύπον	κτύπος	NN	number=SINGULAR|gender=MASCULINE|case=ACCUSATIVE	
Ἄρεος	Ἄρης	NN	number=SINGULAR|gender=MASCULINE|case=GENITIVE	
ἀνδροφόνοιο	ἀνδροφόνος	ADJ	number=SINGULAR|gender=MASCULINE|case=GENITIVE	
ὃς	ὅς	PRON	number=SINGULAR|gender=MASCULINE|case=NOMINATIVE	
νῦν	νῦν	ADV	_	
κεκληγὼς	κλάζω	VB	number=SINGULAR|tense=PERF|mood=PARTICIPLE|voice=ACTIVE|gender=MASCULINE|case=NOMINATIVE	
περιμαίνεται	περιμαίνομαι	VB	person=PERSON_3|number=SINGULAR|tense=PR|mood=INDICATIVE	
ἱερὸν	ἱερός	ADJ	number=SINGULAR|gender=NEUTER|case=ACCUSATIVE	
ἄλσος	ἄλσος	NN	number=SINGULAR|gender=NEUTER|case=ACCUSATIVE	
Φοίβου	Φοῖβος	NN	number=SINGULAR|gender=MASCULINE|case=GENITIVE	
Ἀπόλλωνος	Ἀπόλλων	NN	number=SINGULAR|gender=MASCULINE|case=GENITIVE	
ἑκατηβελέταο	ἑκατηβελέτης	NN	number=SINGULAR|gender=MASCULINE|case=GENITIVE	
ἄνακτος	ἄναξ	NN	number=SINGULAR|gender=MASCULINE|case=GENITIVE	
πᾶν	πᾶς	ADJ	number=SINGULAR|gender=NEUTER|case=NOMINATIVE	
μὲν	μέν		_	
γὰρ	γάρ		_	
κύκλῳ	κύκλος	NN	number=SINGULAR|gender=MASCULINE|case=DATIVE	
τιτάνῳ	τίτανος	NN	number=SINGULAR|gender=FEMININE|case=DATIVE	
λευκῷ	λευκός	ADJ	number=SINGULAR|gender=MASCULINE|case=DATIVE	
τ̓	τε		_	
ἐλέφαντι	ἐλέφας	NN	number=SINGULAR|gender=MASCULINE|case=DATIVE	
ἠλέκτρῳ	ἤλεκτρον	NN	number=SINGULAR|gender=MASCULINE|case=DATIVE	
θ̓	τε		_	
ὑπολαμπὲς	ὑπολαμπής	ADJ	number=SINGULAR|gender=NEUTER|case=NOMINATIVE	
ἔην	εἰμί	VB	person=PERSON_3|number=SINGULAR|tense=IMP|mood=INDICATIVE|voice=ACTIVE	
χρυσῷ	χρυσός	NN	number=SINGULAR|gender=MASCULINE|case=DATIVE	
τε	τε		_	
φαεινῷ	φαεινός	ADJ	number=SINGULAR|gender=MASCULINE|case=DATIVE	
λαμπόμενον	λάμπω	VB	number=SINGULAR|tense=PR|mood=PARTICIPLE|gender=NEUTER|case=NOMINATIVE	
κυάνου	κύανος	NN	number=SINGULAR|gender=MASCULINE|case=GENITIVE	
δὲ	δέ		_	
διὰ	διά	PREP	_	
πτύχες	πτύξ	NN	number=PLURAL|gender=FEMININE|case=NOMINATIVE	
ἠλήλαντο	ἐλαύνω	VB	person=PERSON_3|number=PLURAL|tense=PLUSQUAMPERFECT|mood=INDICATIVE	
οἳ	ὁ	PRON	number=PLURAL|gender=MASCULINE|case=NOMINATIVE	
δ̓	δέ		_	
ἐμάχοντο	μάχομαι	VB	person=PERSON_3|number=PLURAL|tense=IMP|mood=INDICATIVE	
πύξ	πύξ	ADV	_	
τε	τε		_	
καὶ	καί	CONJ	_	
ἑλκηδόν	ἑλκηδόν	ADV	_	
τῷ	ὁ	PRON	number=SINGULAR|gender=MASCULINE|case=DATIVE	
δ̓	δέ		_	
ἅμα	ἅμα	ADV	_	
ἱέμενοι	ἵημι	VB	number=PLURAL|tense=PR|mood=PARTICIPLE|gender=MASCULINE|case=NOMINATIVE	
πολέμοιό	πόλεμος	NN	number=SINGULAR|gender=MASCULINE|case=GENITIVE	
τε	τε		_	
φυλόπιδός	φύλοπις	NN	number=SINGULAR|gender=FEMININE|case=GENITIVE	
τε	τε		_	
Βοιωτοὶ	Βοιωτός	NN	number=PLURAL|gender=MASCULINE|case=NOMINATIVE	
πλήξιπποι	πλήξιππος	ADJ	number=PLURAL|gender=MASCULINE|case=NOMINATIVE	
ὑπὲρ	ὑπέρ	PREP	_	
σακέων	σάκος	NN	number=PLURAL|gender=NEUTER|case=GENITIVE	
πνείοντες	πνέω	VB	number=PLURAL|tense=PR|mood=PARTICIPLE|voice=ACTIVE|gender=MASCULINE|case=NOMINATIVE	
Λοκροί	Λοκροί	NN	number=PLURAL|gender=MASCULINE|case=NOMINATIVE	
τ̓	τε		_	
ἀγχέμαχοι	ἀγχέμαχος	ADJ	number=PLURAL|gender=MASCULINE|case=NOMINATIVE	
καὶ	καί	CONJ	_	
Φωκῆες	Φωκεύς	NN	number=PLURAL|gender=MASCULINE|case=NOMINATIVE	
μεγάθυμοι	μεγάθυμος	ADJ	number=PLURAL|gender=MASCULINE|case=NOMINATIVE	
ἕσποντ̓	ἕπομαι	VB	person=PERSON_3|number=PLURAL|mood=INDICATIVE	
Ἀμφιτρυωνιάδης	Ἀμφιτρυωνιάδας	NN	number=SINGULAR|gender=MASCULINE|case=NOMINATIVE	
δέ	δέ		_	
βίη	βία	NN	number=SINGULAR|gender=FEMININE|case=NOMINATIVE	
Ἡρακληείη	Ἡράκλειος	ADJ	number=SINGULAR|gender=FEMININE|case=NOMINATIVE	
μεσσηγὺς	μεσηγύ	PREP	_	
κόρυθός	κόρυς	NN	number=SINGULAR|gender=FEMININE|case=GENITIVE	
τε	τε		_	
καὶ	καί	CONJ	_	
ἀσπίδος	ἀσπίς	NN	number=SINGULAR|gender=FEMININE|case=GENITIVE	
ἔγχεϊ	ἔγχος	NN	number=SINGULAR|gender=NEUTER|case=DATIVE	
μακρῷ	μακρός	ADJ	number=SINGULAR|gender=NEUTER|case=DATIVE	
αὐχένα	αὐχήν	NN	number=SINGULAR|gender=MASCULINE|case=ACCUSATIVE	
γυμνωθέντα	γυμνόω	VB	number=SINGULAR|mood=PARTICIPLE|voice=PASSIVE|gender=MASCULINE|case=ACCUSATIVE	
θοῶς	θοός	ADV	_	
ὑπένερθε	ὑπένερθε	ADV	_	
γενείου	γένειον	NN	number=SINGULAR|gender=NEUTER|case=GENITIVE	
ἤλασ̓	ἐλαύνω	VB	person=PERSON_3|number=SINGULAR|mood=INDICATIVE|voice=ACTIVE	
ἐπικρατέως	ἐπικρατής	ADV	_	
τοὶ	ὁ	PRON	number=PLURAL|gender=MASCULINE|case=NOMINATIVE	
μὲν	μέν		_	
γὰρ	γάρ		_	
ἐυσσώτρου	εὔσωτρος	ADJ	number=SINGULAR|gender=FEMININE|case=GENITIVE	
ἐπ̓	ἐπί	PREP	_	
ἀπήνης	ἀπήνη	NN	number=SINGULAR|gender=FEMININE|case=GENITIVE	
ἤγοντ̓	ἄγω	VB	person=PERSON_3|number=PLURAL|tense=IMP|mood=INDICATIVE	
ἀνδρὶ	ἀνήρ	NN	number=SINGULAR|gender=MASCULINE|case=DATIVE	
γυναῖκα	γυνή	NN	number=SINGULAR|gender=FEMININE|case=ACCUSATIVE	
πολὺς	πολύς	ADJ	number=SINGULAR|gender=MASCULINE|case=NOMINATIVE	
δ̓	δέ		_	
ὑμέναιος	ὑμέναιος	NN	number=SINGULAR|gender=MASCULINE|case=NOMINATIVE	
ὀρώρει	ὄρνυμι	VB	person=PERSON_3|number=SINGULAR|tense=PLUSQUAMPERFECT|mood=INDICATIVE|voice=ACTIVE	
τοὶ	ὁ	PRON	number=PLURAL|gender=MASCULINE|case=NOMINATIVE	
δ̓	δέ		_	
ὑπ̓	ὑπό	PREP	_	
ὀμοκλῆς	ὁμοκλή	NN	number=SINGULAR|gender=FEMININE|case=GENITIVE	
ῥίμφ̓	ῥίμφα	ADV	_	
ἔφερον	φέρω	VB	person=PERSON_3|number=PLURAL|tense=IMP|mood=INDICATIVE|voice=ACTIVE	
θοὸν	θοός	ADJ	number=SINGULAR|gender=NEUTER|case=ACCUSATIVE	
ἅρμα	ἅρμα	NN	number=SINGULAR|gender=NEUTER|case=ACCUSATIVE	
κονίοντες	κονίω	VB	number=PLURAL|tense=PR|mood=PARTICIPLE|voice=ACTIVE|gender=MASCULINE|case=NOMINATIVE	
πεδίοιο	πεδίον	NN	number=SINGULAR|gender=NEUTER|case=GENITIVE	
τῆς	ὁ	PRON	number=SINGULAR|gender=FEMININE|case=GENITIVE	
ἐκ	ἐκ	PREP	_	
μὲν	μέν		_	
ῥινῶν	ῥίς	NN	number=PLURAL|gender=FEMININE|case=GENITIVE	
μύξαι	μύξα	NN	number=PLURAL|gender=FEMININE|case=NOMINATIVE	
ῥέον	ῥέω	VB	person=PERSON_3|number=PLURAL|tense=IMP|mood=INDICATIVE|voice=ACTIVE	
ἐκ	ἐκ	PREP	_	
δὲ	δέ		_	
παρειῶν	παρειά	NN	number=PLURAL|gender=FEMININE|case=GENITIVE	
αἷμ̓	αἷμα	NN	number=SINGULAR|gender=NEUTER|case=NOMINATIVE	
ἀπελείβετ̓	ἀπολείβω	VB	person=PERSON_3|number=SINGULAR|tense=IMP|mood=INDICATIVE	
ἔραζ̓	ἔραζε	ADV	_	
τὸν	ὁ	PRON	number=SINGULAR|gender=MASCULINE|case=ACCUSATIVE	
μὲν	μέν		_	
ἔπειτ̓	ἔπειτα	ADV	_	
εἴασε	ἐάω	VB	person=PERSON_3|number=SINGULAR|mood=INDICATIVE|voice=ACTIVE	
Διὸς	Ζεύς	NN	number=SINGULAR|gender=MASCULINE|case=GENITIVE	
ταλακάρδιος	ταλακάρδιος	ADJ	number=SINGULAR|gender=MASCULINE|case=NOMINATIVE	
υἱός	υἱός	NN	number=SINGULAR|gender=MASCULINE|case=NOMINATIVE	
αὐτὸς	αὐτός	ADJ	number=SINGULAR|gender=MASCULINE|case=NOMINATIVE	
δὲ	δέ		_	
βροτολοιγὸν	βροτολοιγός	ADJ	number=SINGULAR|gender=MASCULINE|case=ACCUSATIVE	
Ἄρην	Ἄρης	NN	number=SINGULAR|gender=MASCULINE|case=ACCUSATIVE	
προσιόντα	πρόσειμι	VB	number=SINGULAR|tense=PR|mood=PARTICIPLE|voice=ACTIVE|gender=MASCULINE|case=ACCUSATIVE	
δοκεύσας	δοκεύω	VB	number=SINGULAR|mood=PARTICIPLE|voice=ACTIVE|gender=MASCULINE|case=NOMINATIVE	
δεινὸν	δεινός	ADJ	number=SINGULAR|gender=NEUTER|case=ACCUSATIVE	
ὁρῶν	ὁράω	VB	number=SINGULAR|tense=PR|mood=PARTICIPLE|voice=ACTIVE|gender=MASCULINE|case=NOMINATIVE	
ὄσσοισι	ὄσσε	NN	number=PLURAL|gender=NEUTER|case=DATIVE	
λέων	λέων	NN	number=SINGULAR|gender=MASCULINE|case=NOMINATIVE	
ὣς	ὡς	ADV	_	
σώματι	σῶμα	NN	number=SINGULAR|gender=NEUTER|case=DATIVE	
κύρσας	κυρέω	VB	number=SINGULAR|mood=PARTICIPLE|voice=ACTIVE|gender=MASCULINE|case=NOMINATIVE	
ὅς	ὅς	PRON	number=SINGULAR|gender=MASCULINE|case=NOMINATIVE	
τε	τε		_	
μάλ̓	μάλα	ADV	_	
ἐνδυκέως	ἐνδυκέως	ADV	_	
ῥινὸν	ῥινός	NN	number=SINGULAR|gender=FEMININE|case=ACCUSATIVE	
κρατεροῖς	κρατερός	ADJ	number=PLURAL|gender=MASCULINE|case=DATIVE	
ὀνύχεσσι	ὄνυξ	NN	number=PLURAL|gender=MASCULINE|case=DATIVE	
σχίσσας	σχίζω	VB	number=SINGULAR|mood=PARTICIPLE|voice=ACTIVE|gender=MASCULINE|case=NOMINATIVE	
ὅττι	ὅτι	ADV	_	
τάχιστα	ταχύς	ADJ	number=PLURAL|gender=NEUTER|case=ACCUSATIVE|degree=SUPERLATIVE	
μελίφρονα	μελίφρων	NN	number=SINGULAR|gender=MASCULINE|case=ACCUSATIVE	
θυμὸν	θυμός	NN	number=SINGULAR|gender=MASCULINE|case=ACCUSATIVE	
ἀπηύρα	ἀπαυράω	VB	person=PERSON_3|number=SINGULAR|tense=IMP|mood=INDICATIVE|voice=ACTIVE	
ἀμφὶ	ἀμφί	PREP	_	
δέ	δέ		_	
μιν	μιν	PRON	number=SINGULAR|gender=FEMININE|case=ACCUSATIVE	
κίβισις	κίβισις	NN	number=SINGULAR|gender=FEMININE|case=NOMINATIVE	
θέε	θέω	VB	person=PERSON_3|number=SINGULAR|tense=IMP|mood=INDICATIVE|voice=ACTIVE	
θαῦμα	θαῦμα	NN	number=SINGULAR|gender=NEUTER|case=NOMINATIVE	
ἰδέσθαι	εἶδον	VB	mood=INFINITIVE	
ἀργυρέη	ἀργύρεος	ADJ	number=SINGULAR|gender=FEMININE|case=NOMINATIVE	
ἔνθ̓	ἔνθα	ADV	_	
ἦ	ἦ	ADV	_	
τοι	τοι		_	
Κύκνος	Κύκνος	NN	number=SINGULAR|gender=MASCULINE|case=NOMINATIVE	
μὲν	μέν		_	
ὑπερμενέος	ὑπερμενής	ADJ	number=SINGULAR|gender=MASCULINE|case=GENITIVE	
Διὸς	Ζεύς	NN	number=SINGULAR|gender=MASCULINE|case=GENITIVE	
υἱὸν	υἱός	NN	number=SINGULAR|gender=MASCULINE|case=ACCUSATIVE	
κτεινέμεναι	κτείνω	VB	tense=PR|mood=INFINITIVE|voice=ACTIVE	
μεμαὼς	μέμαα	VB	number=SINGULAR|tense=PERF|mood=PARTICIPLE|voice=ACTIVE|gender=MASCULINE|case=NOMINATIVE	
σάκει	σάκος	NN	number=SINGULAR|gender=NEUTER|case=DATIVE	
ἔμβαλε	ἐμβάλλω	VB	person=PERSON_3|number=SINGULAR|mood=INDICATIVE|voice=ACTIVE	
χάλκεον	χάλκεος	ADJ	number=SINGULAR|gender=NEUTER|case=ACCUSATIVE	
ἔγχος	ἔγχος	NN	number=SINGULAR|gender=NEUTER|case=ACCUSATIVE	
οὐ	οὐ	ADV	_	
δ̓	δέ		_	
ἔρρηξεν	ῥήγνυμι	VB	person=PERSON_3|number=SINGULAR|mood=INDICATIVE|voice=ACTIVE	
χαλκόν	χαλκός	NN	number=SINGULAR|gender=MASCULINE|case=ACCUSATIVE	
ἡνίοχοι	ἡνίοχος	NN	number=PLURAL|gender=MASCULINE|case=NOMINATIVE	
δ̓	δέ		_	
ἔμπλην	ἔμπλην	ADV	_	
ἔλασαν	ἐλαύνω	VB	person=PERSON_3|number=PLURAL|mood=INDICATIVE|voice=ACTIVE	
καλλίτριχας	καλλίθριξ	NN	number=PLURAL|gender=MASCULINE|case=ACCUSATIVE	
ἵππους	ἵππος	NN	number=PLURAL|gender=MASCULINE|case=ACCUSATIVE	
ἔνθα	ἔνθα	ADV	_	
κε	ἄν		_	
δὴ	δή		_	
λωβητὸς	λωβητός	ADJ	number=SINGULAR|gender=MASCULINE|case=NOMINATIVE	
ἐν	ἐν	PREP	_	
ἀθανάτοισιν	ἀθάνατος	ADJ	number=PLURAL|gender=MASCULINE|case=DATIVE	
ἐτύχθη	τεύχω	VB	person=PERSON_3|number=SINGULAR|mood=INDICATIVE|voice=PASSIVE	
χερσὶν	χείρ	NN	number=PLURAL|gender=FEMININE|case=DATIVE	
ὕφ̓	ὑπό	PREP	_	
ἡμετέρῃσι	ἡμέτερος	ADJ	number=PLURAL|gender=FEMININE|case=DATIVE	
λιπὼν	λείπω	VB	number=SINGULAR|mood=PARTICIPLE|voice=ACTIVE|gender=MASCULINE|case=NOMINATIVE	
ἔναρα	ἔναρα	NN	number=PLURAL|gender=NEUTER|case=ACCUSATIVE	
βροτόεντα	βροτόεις	ADJ	number=PLURAL|gender=NEUTER|case=ACCUSATIVE	
ἀμφὶ	ἀμφί	PREP	_	
δέ	δέ		_	
οἱ	ἕ	PRON	number=SINGULAR|gender=MASCULINE|case=DATIVE	
βράχε	βραχεῖν	VB	person=PERSON_3|number=SINGULAR|mood=INDICATIVE|voice=ACTIVE	
τεύχεα	τεῦχος	NN	number=PLURAL|gender=NEUTER|case=NOMINATIVE	
ποικίλα	ποικίλος	ADJ	number=PLURAL|gender=NEUTER|case=NOMINATIVE	
χαλκῷ	χαλκός	NN	number=SINGULAR|gender=MASCULINE|case=DATIVE	
ἠθεῖ̓	ἠθεῖος	ADJ	number=SINGULAR|gender=MASCULINE|case=VOCATIVE	
ἦ	ἦ	ADV	_	
μάλα	μάλα	ADV	_	
δή	δή		_	
τι	τις	PRON	number=SINGULAR|gender=NEUTER|case=ACCUSATIVE	
πατὴρ	πατήρ	NN	number=SINGULAR|gender=MASCULINE|case=NOMINATIVE	
ἀνδρῶν	ἀνήρ	NN	number=PLURAL|gender=MASCULINE|case=GENITIVE	
τε	τε		_	
θεῶν	θεός	NN	number=PLURAL|gender=MASCULINE|case=GENITIVE	
τε	τε		_	
τιμᾷ	τιμάω	VB	person=PERSON_3|number=SINGULAR|tense=PR|mood=INDICATIVE|voice=ACTIVE	
σὴν	σός	ADJ	number=SINGULAR|gender=FEMININE|case=ACCUSATIVE	
κεφαλὴν	κεφαλή	NN	number=SINGULAR|gender=FEMININE|case=ACCUSATIVE	
καὶ	καί	CONJ	_	
ταύρεος	ταύρεος	ADJ	number=SINGULAR|gender=MASCULINE|case=NOMINATIVE	
Ἐννοσίγαιος	Ἐννοσίγαιος	NN	number=SINGULAR|gender=MASCULINE|case=NOMINATIVE	
ὃς	ὅς	PRON	number=SINGULAR|gender=MASCULINE|case=NOMINATIVE	
Θήβης	Θήβη	NN	number=SINGULAR|gender=FEMININE|case=GENITIVE	
κρήδεμνον	κρήδεμνον	NN	number=SINGULAR|gender=NEUTER|case=ACCUSATIVE	
ἔχει	ἔχω	VB	person=PERSON_3|number=SINGULAR|tense=PR|mood=INDICATIVE|voice=ACTIVE	
ῥύεταί	ῥύομαι	VB	person=PERSON_3|number=SINGULAR|tense=PR|mood=INDICATIVE	
τε	τε		_	
πόληα	πόλις	NN	number=SINGULAR|gender=FEMININE|case=ACCUSATIVE	
παρὰ	παρά	PREP	_	
δὲ	δέ		_	
Δεῖμός	Δεῖμος	NN	number=SINGULAR|gender=MASCULINE|case=NOMINATIVE	
τε	τε		_	
Φόβος	φόβος	NN	number=SINGULAR|gender=MASCULINE|case=NOMINATIVE	
τε	τε		_	
ἕστασαν	ἵστημι	VB	person=PERSON_3|number=PLURAL|tense=PLUSQUAMPERFECT|mood=INDICATIVE|voice=ACTIVE	
ἱέμενοι	ἵημι	VB	number=PLURAL|tense=PR|mood=PARTICIPLE|gender=MASCULINE|case=NOMINATIVE	
πόλεμον	πόλεμος	NN	number=SINGULAR|gender=MASCULINE|case=ACCUSATIVE	
καταδύμεναι	καταδύω	VB	mood=INFINITIVE|voice=ACTIVE	
ἀνδρῶν	ἀνήρ	NN	number=PLURAL|gender=MASCULINE|case=GENITIVE	
ἀμφότεροι	ἀμφότερος	ADJ	number=PLURAL|gender=MASCULINE|case=NOMINATIVE	
δ̓	δέ		_	
ἰάχοντες	ἰάχω	VB	number=PLURAL|tense=PR|mood=PARTICIPLE|voice=ACTIVE|gender=MASCULINE|case=NOMINATIVE	
ἐπ̓	ἐπί	PREP	_	
ἀλλήλοισιν	ἀλλήλων	ADJ	number=PLURAL|gender=MASCULINE|case=DATIVE	
ὄρουσαν	ὀρούω	VB	person=PERSON_3|number=PLURAL|mood=INDICATIVE|voice=ACTIVE	
τὼς	τώς	ADV	_	
γάρ	γάρ		_	
μιν	μιν	PRON	number=SINGULAR|gender=MASCULINE|case=ACCUSATIVE	
Ἀπόλλων	Ἀπόλλων	NN	number=SINGULAR|gender=MASCULINE|case=NOMINATIVE	
Λητοΐδης	Λητοίδης	NN	number=SINGULAR|gender=MASCULINE|case=NOMINATIVE	
ἤνωξ̓	ἄνωγα	VB	person=PERSON_3|number=SINGULAR|mood=INDICATIVE|voice=ACTIVE	
ὅτι	ὅτι	CONJ	_	
ῥα	ἄρα		_	
κλειτὰς	κλειτός	ADJ	number=PLURAL|gender=FEMININE|case=ACCUSATIVE	
ἑκατόμβας	ἑκατόμβη	NN	number=PLURAL|gender=FEMININE|case=ACCUSATIVE	
ὅστις	ὅστις	PRON	number=SINGULAR|gender=MASCULINE|case=NOMINATIVE	
ἄγοι	ἄγω	VB	person=PERSON_3|number=SINGULAR|tense=PR|voice=ACTIVE	
Πυθοῖδε	Πυθώ	NN	number=SINGULAR|gender=FEMININE|case=DATIVE	
βίῃ	βία	NN	number=SINGULAR|gender=FEMININE|case=DATIVE	
σύλασκε	συλάω	VB	person=PERSON_3|number=SINGULAR|tense=IMP|mood=INDICATIVE|voice=ACTIVE	
δοκεύων	δοκεύω	VB	number=SINGULAR|tense=PR|mood=PARTICIPLE|voice=ACTIVE|gender=MASCULINE|case=NOMINATIVE	
ὦ	ὦ		_	
πέπον	πέπων	ADJ	number=SINGULAR|gender=MASCULINE|case=VOCATIVE	
οὐ	οὐ	ADV	_	
μὲν	μέν		_	
γὰρ	γάρ		_	
τοι	σύ	PRON	number=SINGULAR|gender=MASCULINE|case=DATIVE	
Ἄρης	Ἄρης	NN	number=SINGULAR|gender=MASCULINE|case=NOMINATIVE	
θανάτοιο	θάνατος	NN	number=SINGULAR|gender=MASCULINE|case=GENITIVE	
τελευτὴν	τελευτή	NN	number=SINGULAR|gender=FEMININE|case=ACCUSATIVE	
ἀρκέσει	ἀρκέω	VB	person=PERSON_3|number=SINGULAR|tense=FUTURE|mood=INDICATIVE|voice=ACTIVE	
εἰ	εἰ	CONJ	_	
δὴ	δή		_	
νῶι	ἐγώ	PRON	gender=MASCULINE|case=NOMINATIVE	
συνοισόμεθα	συμφέρω	VB	person=PERSON_1|number=PLURAL|tense=FUTURE|mood=INDICATIVE	
πτολεμίζειν	πολεμίζω	VB	tense=PR|mood=INFINITIVE|voice=ACTIVE	
ἣ	ὁ	PRON	number=SINGULAR|gender=FEMININE|case=NOMINATIVE	
δὲ	δέ		_	
θεῷ	θεός	NN	number=SINGULAR|gender=MASCULINE|case=DATIVE	
δμηθεῖσα	δαμάζω	VB	number=SINGULAR|mood=PARTICIPLE|voice=PASSIVE|gender=FEMININE|case=NOMINATIVE	
καὶ	καί	CONJ	_	
ἀνέρι	ἀνήρ	NN	number=SINGULAR|gender=MASCULINE|case=DATIVE	
πολλὸν	πολύς	ADJ	number=SINGULAR|gender=NEUTER|case=ACCUSATIVE	
ἀρίστῳ	ἄριστος	ADJ	number=SINGULAR|gender=MASCULINE|case=DATIVE	
Θήβῃ	Θήβη	NN	number=SINGULAR|gender=FEMININE|case=DATIVE	
ἐν	ἐν	PREP	_	
ἑπταπύλῳ	ἑπτάπυλος	ADJ	number=SINGULAR|gender=FEMININE|case=DATIVE	
διδυμάονε	διδυμάων	NN	gender=MASCULINE|case=ACCUSATIVE	
γείνατο	γείνομαι	VB	person=PERSON_3|number=SINGULAR|mood=INDICATIVE	
παῖδε	παῖς	NN	gender=MASCULINE|case=ACCUSATIVE	
οὐ	οὐ	ADV	_	
καθ̓	κατά	PREP	_	
ὁμὰ	ὁμός	ADJ	number=PLURAL|gender=NEUTER|case=ACCUSATIVE	
φρονέοντε	φρονέω	VB	tense=PR|mood=PARTICIPLE|voice=ACTIVE|gender=MASCULINE|case=ACCUSATIVE	
στίγματα	στίγμα	NN	number=PLURAL|gender=NEUTER|case=NOMINATIVE	
δ̓	δέ		_	
ὣς	ὡς	ADV	_	
ἐπέφαντο	φαίνω	VB	person=PERSON_3|number=PLURAL|tense=PLUSQUAMPERFECT|mood=INDICATIVE	
ἰδεῖν	εἶδον	VB	mood=INFINITIVE|voice=ACTIVE	
δεινοῖσι	δεινός	ADJ	number=PLURAL|gender=MASCULINE|case=DATIVE	
δράκουσιν	δράκων	NN	number=PLURAL|gender=MASCULINE|case=DATIVE	
τοὶ	ὁ	PRON	number=PLURAL|gender=MASCULINE|case=NOMINATIVE	
δ̓	δέ		_	
ὠκύποδας	ὠκύπους	NN	number=PLURAL|gender=MASCULINE|case=ACCUSATIVE	
λαγὸς	λαγώς	NN	number=PLURAL|gender=MASCULINE|case=ACCUSATIVE	
ᾕρευν	αἱρέω	VB	person=PERSON_3|number=PLURAL|tense=IMP|mood=INDICATIVE|voice=ACTIVE	
ἄνδρες	ἀνήρ	NN	number=PLURAL|gender=MASCULINE|case=NOMINATIVE	
θηρευταί	θηρευτής	NN	number=PLURAL|gender=MASCULINE|case=NOMINATIVE	
καὶ	καί	CONJ	_	
καρχαρόδοντε	καρχαρόδους	ADJ	gender=MASCULINE|case=NOMINATIVE	
κύνε	κύων	NN	gender=MASCULINE|case=NOMINATIVE	
πρό	πρό	ADV	_	
ἱέμενοι	ἵημι	VB	number=PLURAL|tense=PR|mood=PARTICIPLE|gender=MASCULINE|case=NOMINATIVE	
μαπέειν	μάρπτω	VB	mood=INFINITIVE|voice=ACTIVE	
οἳ	ὁ	PRON	number=PLURAL|gender=MASCULINE|case=NOMINATIVE	
δ̓	δέ		_	
ἱέμενοι	ἵημι	VB	number=PLURAL|tense=PR|mood=PARTICIPLE|gender=MASCULINE|case=NOMINATIVE	
ὑπαλύξαι	ὑπαλύσκω	VB	mood=INFINITIVE|voice=ACTIVE	
ἐπὶ	ἐπί	PREP	_	
δὲ	δέ		_	
χλωροῦ	χλωρός	ADJ	number=SINGULAR|gender=MASCULINE|case=GENITIVE	
ἀδάμαντος	ἀδάμας	ADJ	number=SINGULAR|gender=MASCULINE|case=GENITIVE	
βαινουσέων	βαίνω	VB	number=PLURAL|tense=PR|mood=PARTICIPLE|voice=ACTIVE|gender=FEMININE|case=GENITIVE	
ἰάχεσκε	ἰάχω	VB	person=PERSON_3|number=SINGULAR|tense=IMP|mood=INDICATIVE|voice=ACTIVE	
σάκος	σάκος	NN	number=SINGULAR|gender=NEUTER|case=NOMINATIVE	
μεγάλῳ	μέγας	ADJ	number=SINGULAR|gender=MASCULINE|case=DATIVE	
ὀρυμαγδῷ	ὀρυμαγδός	NN	number=SINGULAR|gender=MASCULINE|case=DATIVE	
ὀξέα	ὁξύς	ADJ	number=PLURAL|gender=NEUTER|case=ACCUSATIVE	
καὶ	καί	CONJ	_	
λιγέως	λιγύς	ADV	_	
τῶν	ὁ	PRON	number=PLURAL|gender=MASCULINE|case=GENITIVE	
δ̓	δέ		_	
ὕπο	ὑπό	PREP	_	
σευομένων	σεύω	VB	number=PLURAL|tense=PR|mood=PARTICIPLE|gender=MASCULINE|case=GENITIVE	
κανάχιζε	καναχίζω	VB	person=PERSON_3|number=SINGULAR|tense=IMP|mood=INDICATIVE|voice=ACTIVE	
πόσ̓	πούς	NN	number=PLURAL|gender=MASCULINE|case=DATIVE	
εὐρεῖα	εὐρύς	ADJ	number=SINGULAR|gender=FEMININE|case=NOMINATIVE	
χθών	χθών	NN	number=SINGULAR|gender=FEMININE|case=NOMINATIVE	
ἥρως	ἥρως	NN	number=SINGULAR|gender=MASCULINE|case=VOCATIVE	
ὦ	ὦ		_	
Ἰόλαε	Ἰόλαος	NN	number=SINGULAR|gender=MASCULINE|case=VOCATIVE	
βροτῶν	βροτός	NN	number=PLURAL|gender=MASCULINE|case=GENITIVE	
πολὺ	πολύς	ADJ	number=SINGULAR|gender=NEUTER|case=ACCUSATIVE	
φίλτατε	φίλτατος	ADJ	number=SINGULAR|gender=MASCULINE|case=VOCATIVE	
πάντων	πᾶς	ADJ	number=PLURAL|gender=MASCULINE|case=GENITIVE	
ἦ	ἦ	ADV	_	
τε	τε		_	
μέγ̓	μέγας	ADJ	number=SINGULAR|gender=NEUTER|case=ACCUSATIVE	
ἀθανάτους	ἀθάνατος	ADJ	number=PLURAL|gender=MASCULINE|case=ACCUSATIVE	
μάκαρας	μάκαρ	NN	number=PLURAL|gender=MASCULINE|case=ACCUSATIVE	
τοὶ	ὁ	PRON	number=PLURAL|gender=MASCULINE|case=NOMINATIVE	
Ὄλυμπον	Ὄλυμπος	NN	number=SINGULAR|gender=MASCULINE|case=ACCUSATIVE	
ἔχουσιν	ἔχω	VB	person=PERSON_3|number=PLURAL|tense=PR|mood=INDICATIVE|voice=ACTIVE	
ἤλιτεν	ἀλιταίνω	VB	person=PERSON_3|number=SINGULAR|mood=INDICATIVE|voice=ACTIVE	
Ἀμφιτρύων	Ἀμφιτρύων	NN	number=SINGULAR|gender=MASCULINE|case=NOMINATIVE	
ὅτ̓	ὅτε	CONJ	_	
ἐυστέφανον	εὐστέφανος	ADJ	number=SINGULAR|gender=FEMININE|case=ACCUSATIVE	
ποτὶ	πρός	PREP	_	
Θήβην	Θήβη	NN	number=SINGULAR|gender=FEMININE|case=ACCUSATIVE	
ἦλθε	ἔρχομαι	VB	person=PERSON_3|number=SINGULAR|mood=INDICATIVE|voice=ACTIVE	
λιπὼν	λείπω	VB	number=SINGULAR|mood=PARTICIPLE|voice=ACTIVE|gender=MASCULINE|case=NOMINATIVE	
Τίρυνθα	Τίρυνς	NN	number=SINGULAR|gender=FEMININE|case=ACCUSATIVE	
ἐυκτίμενον	ἐυκτίμενος	ADJ	number=SINGULAR|gender=NEUTER|case=ACCUSATIVE	
πτολίεθρον	πτολίεθρον	NN	number=SINGULAR|gender=NEUTER|case=ACCUSATIVE	
κτείνας	κτείνω	VB	number=SINGULAR|mood=PARTICIPLE|voice=ACTIVE|gender=MASCULINE|case=NOMINATIVE	
Ἠλεκτρύωνα	Ἠλεκτρύων	NN	number=SINGULAR|gender=MASCULINE|case=ACCUSATIVE	
βοῶν	βοῦς	NN	number=PLURAL|gender=MASCULINE|case=GENITIVE	
ἕνεκ̓	ἕνεκα	PREP	_	
εὐρυμετώπων	εὐρυμέτωπος	ADJ	number=PLURAL|gender=MASCULINE|case=GENITIVE	
ἐν	ἐν	PREP	_	
δ̓	δέ		_	
ἄρα	ἄρα		_	
μέσσῳ	μέσος	ADJ	number=SINGULAR|gender=NEUTER|case=DATIVE	
ἱμερόεν	ἱμερόεις	ADJ	number=SINGULAR|gender=NEUTER|case=ACCUSATIVE	
κιθάριζε	κιθαρίζω	VB	person=PERSON_3|number=SINGULAR|tense=IMP|mood=INDICATIVE|voice=ACTIVE	
Διὸς	Ζεύς	NN	number=SINGULAR|gender=MASCULINE|case=GENITIVE	
καὶ	καί	CONJ	_	
Λητοῦς	Λητώ	NN	number=SINGULAR|gender=FEMININE|case=GENITIVE	
υἱὸς	υἱός	NN	number=SINGULAR|gender=MASCULINE|case=NOMINATIVE	
χρυσείῃ	χρύσεος	ADJ	number=SINGULAR|gender=FEMININE|case=DATIVE	
φόρμιγγι	φόρμιγξ	NN	number=SINGULAR|gender=FEMININE|case=DATIVE	
εἵλετο	αἱρέω	VB	person=PERSON_3|number=SINGULAR|mood=INDICATIVE	
δ̓	δέ		_	
ὄβριμον	ὄβριμος	ADJ	number=SINGULAR|gender=NEUTER|case=ACCUSATIVE	
ἔγχος	ἔγχος	NN	number=SINGULAR|gender=NEUTER|case=ACCUSATIVE	
ἀκαχμένον	ἀκαχμένος	ADJ	number=SINGULAR|gender=NEUTER|case=ACCUSATIVE	
αἴθοπι	αἶθοψ	NN	number=SINGULAR|gender=MASCULINE|case=DATIVE	
χαλκῷ	χαλκός	NN	number=SINGULAR|gender=MASCULINE|case=DATIVE	
κρατὶ	κράς	NN	number=SINGULAR|gender=FEMININE|case=DATIVE	
δ̓	δέ		_	
ἔπ̓	ἐπί	PREP	_	
ἰφθίμῳ	ἴφθιμος	ADJ	number=SINGULAR|gender=FEMININE|case=DATIVE	
κυνέην	κυνέη	NN	number=SINGULAR|gender=FEMININE|case=ACCUSATIVE	
ἐύτυκτον	εὔτυκτος	ADJ	number=SINGULAR|gender=FEMININE|case=ACCUSATIVE	
ἔθηκε	τίθημι	VB	person=PERSON_3|number=SINGULAR|mood=INDICATIVE|voice=ACTIVE	
δαιδαλέην	δαιδάλεος	ADJ	number=SINGULAR|gender=FEMININE|case=ACCUSATIVE	
ἀδάμαντος	ἀδάμας	ADJ	number=SINGULAR|gender=MASCULINE|case=GENITIVE	
ἐπὶ	ἐπί	PREP	_	
κροτάφοις	κρόταφος	NN	number=PLURAL|gender=MASCULINE|case=DATIVE	
ἀραρυῖαν	ἀραρίσκω	VB	number=SINGULAR|tense=PERF|mood=PARTICIPLE|voice=ACTIVE|gender=FEMININE|case=ACCUSATIVE	
ἥτ̓	ὅστε	PRON	number=SINGULAR|gender=FEMININE|case=NOMINATIVE	
εἴρυτο	ἐρύω	VB	person=PERSON_3|number=SINGULAR|tense=PLUSQUAMPERFECT|mood=INDICATIVE	
κάρη	κάρα	NN	number=SINGULAR|gender=NEUTER|case=ACCUSATIVE	
Ἡρακλῆος	Ἡρακλέης	NN	number=SINGULAR|gender=MASCULINE|case=GENITIVE	
θείοιο	θεῖος	ADJ	number=SINGULAR|gender=MASCULINE|case=GENITIVE	
ἀπὸ	ἀπό	PREP	_	
δὲ	δέ		_	
γλαυκῶπις	γλαυκῶπις	ADJ	number=SINGULAR|gender=FEMININE|case=NOMINATIVE	
Ἀθήνη	Ἀθήνη	NN	number=SINGULAR|gender=FEMININE|case=NOMINATIVE	
ἔγχεος	ἔγχος	NN	number=SINGULAR|gender=NEUTER|case=GENITIVE	
ὁρμὴν	ὁρμή	NN	number=SINGULAR|gender=FEMININE|case=ACCUSATIVE	
ἔτραπ̓	τρέπω	VB	person=PERSON_3|number=SINGULAR|mood=INDICATIVE|voice=ACTIVE	
ὀρεξαμένη	ὀρέγω	VB	number=SINGULAR|mood=PARTICIPLE|gender=FEMININE|case=NOMINATIVE	
ἀπὸ	ἀπό	PREP	_	
δίφρου	δίφρος	NN	number=SINGULAR|gender=MASCULINE|case=GENITIVE	
κασιγνήτω	κασίγνητος	NN	gender=MASCULINE|case=NOMINATIVE	
γε	γε		_	
μὲν	μέν		_	
ἤστην	εἰμί	VB	person=PERSON_3|tense=IMP|mood=INDICATIVE|voice=ACTIVE	
ἐπὶ	ἐπί	PREP	_	
δ̓	δέ		_	
ἱππείου	ἵππειος	ADJ	number=SINGULAR|gender=MASCULINE|case=GENITIVE	
θόρε	θρῴσκω	VB	person=PERSON_3|number=SINGULAR|mood=INDICATIVE|voice=ACTIVE	
δίφρου	δίφρος	NN	number=SINGULAR|gender=MASCULINE|case=GENITIVE	
εἴκελος	εἴκελος	ADJ	number=SINGULAR|gender=MASCULINE|case=NOMINATIVE	
ἀστεροπῇ	ἀστεροπή	NN	number=SINGULAR|gender=FEMININE|case=DATIVE	
πατρὸς	πατήρ	NN	number=SINGULAR|gender=MASCULINE|case=GENITIVE	
Διὸς	Ζεύς	NN	number=SINGULAR|gender=MASCULINE|case=GENITIVE	
αἰγιόχοιο	αἰγίοχος	ADJ	number=SINGULAR|gender=MASCULINE|case=GENITIVE	
κοῦφα	κοῦφος	ADJ	number=PLURAL|gender=NEUTER|case=ACCUSATIVE	
βιβάς	βίβημι	VB	number=SINGULAR|tense=PR|mood=PARTICIPLE|voice=ACTIVE|gender=MASCULINE|case=NOMINATIVE	
τοὶ	ὁ		number=PLURAL|gender=MASCULINE|case=NOMINATIVE	
δ̓	δέ		_	
ἄνδρες	ἀνήρ	NN	number=PLURAL|gender=MASCULINE|case=NOMINATIVE	
ἐν	ἐν	PREP	_	
ἀγλαΐῃς	ἀγλαία	NN	number=PLURAL|gender=FEMININE|case=DATIVE	
τε	τε		_	
χοροῖς	χορός	NN	number=PLURAL|gender=MASCULINE|case=DATIVE	
τε	τε		_	
τέρψιν	τέρψις	NN	number=SINGULAR|gender=FEMININE|case=ACCUSATIVE	
ἔχον	ἔχω	VB	person=PERSON_3|number=PLURAL|tense=IMP|mood=INDICATIVE|voice=ACTIVE	
ἔσαν	εἰμί	VB	person=PERSON_3|number=PLURAL|tense=IMP|mood=INDICATIVE|voice=ACTIVE	
ἠδὲ	ἠδέ	CONJ	_	
λεόντων	λέων	NN	number=PLURAL|gender=MASCULINE|case=GENITIVE	
ἐς	εἰς	PREP	_	
σφέας	σφεῖς	PRON	number=PLURAL|gender=MASCULINE|case=ACCUSATIVE	
δερκομένων	δέρκομαι	VB	number=PLURAL|tense=PR|mood=PARTICIPLE|gender=MASCULINE|case=GENITIVE	
κοτεόντων	κοτέω	VB	number=PLURAL|tense=PR|mood=PARTICIPLE|voice=ACTIVE|gender=MASCULINE|case=GENITIVE	
θ̓	τε		_	
ἱεμένων	ἵημι	VB	number=PLURAL|tense=PR|mood=PARTICIPLE|gender=MASCULINE|case=GENITIVE	
τε	τε		_	
παρὰ	παρά	PREP	_	
δέ	δέ		_	
σφισιν	σφεῖς	PRON	number=PLURAL|gender=MASCULINE|case=DATIVE	
ὄρχος	ὄρχος	NN	number=SINGULAR|gender=MASCULINE|case=NOMINATIVE	
χρύσεος	χρύσεος	ADJ	number=SINGULAR|gender=MASCULINE|case=NOMINATIVE	
ἦν	εἰμί	VB	person=PERSON_3|number=SINGULAR|tense=IMP|mood=INDICATIVE|voice=ACTIVE	
κλυτὰ	κλυτός	ADJ	number=PLURAL|gender=NEUTER|case=NOMINATIVE	
ἔργα	ἔργον	NN	number=PLURAL|gender=NEUTER|case=NOMINATIVE	
περίφρονος	περίφρων	NN	number=SINGULAR|gender=MASCULINE|case=GENITIVE	
Ἡφαίστοιο	Ἥφαιστος	NN	number=SINGULAR|gender=MASCULINE|case=GENITIVE	
σειόμενος	σείω	VB	number=SINGULAR|tense=PR|mood=PARTICIPLE|gender=MASCULINE|case=NOMINATIVE	
φύλλοισι	φύλλον	NN	number=PLURAL|gender=NEUTER|case=DATIVE	
καὶ	καί	CONJ	_	
ἀργυρέῃσι	ἀργύρεος	ADJ	number=PLURAL|gender=FEMININE|case=DATIVE	
κάμαξι	κάμαξ	NN	number=PLURAL|gender=FEMININE|case=DATIVE	
βριθόμενος	βρίθω	VB	number=SINGULAR|tense=PR|mood=PARTICIPLE|gender=MASCULINE|case=NOMINATIVE	
σταφυλῇσι	σταφυλή	NN	number=PLURAL|gender=FEMININE|case=DATIVE	
τάχα	τάχα	ADV	_	
δ̓	δέ		_	
ἄμμες	ἐγώ	PRON	number=PLURAL|gender=MASCULINE|case=NOMINATIVE	
ἐπιπλομένων	ἐπιπέλομαι	VB	number=PLURAL|tense=PR|mood=PARTICIPLE|gender=MASCULINE|case=GENITIVE	
ἐνιαυτῶν	ἐνιαυτός	NN	number=PLURAL|gender=MASCULINE|case=GENITIVE	
γεινόμεθ̓	γείνομαι	VB	person=PERSON_1|number=PLURAL|tense=IMP|mood=INDICATIVE	
οὔ	οὐ	ADV	_	
τε	τε		_	
φυὴν	φυή	NN	number=SINGULAR|gender=FEMININE|case=ACCUSATIVE	
ἐναλίγκιοι	ἐναλίγκιος	ADJ	number=PLURAL|gender=MASCULINE|case=NOMINATIVE	
οὔ	οὔτι	ADV	_	
τε	τε		_	
νόημα	νόημα	NN	number=SINGULAR|gender=NEUTER|case=ACCUSATIVE	
σός	σός	ADJ	number=SINGULAR|gender=MASCULINE|case=NOMINATIVE	
τε	τε		_	
πατὴρ	πατήρ	NN	number=SINGULAR|gender=MASCULINE|case=NOMINATIVE	
καὶ	καί	CONJ	_	
ἐγώ	ἐγώ	PRON	number=SINGULAR|gender=MASCULINE|case=NOMINATIVE	
ἤδη	ἤδη	ADV	_	
μέν	μέν		_	
τέ	τε		_	
ἕ	ἕ	PRON	number=SINGULAR|gender=MASCULINE|case=ACCUSATIVE	
φημι	φημί	VB	person=PERSON_1|number=SINGULAR|tense=PR|mood=INDICATIVE|voice=ACTIVE	
καὶ	καί	ADV	_	
ἄλλοτε	ἄλλοτε	ADV	_	
πειρηθῆναι	πειράω	VB	mood=INFINITIVE|voice=PASSIVE	
ἔγχεος	ἔγχος	NN	number=SINGULAR|gender=NEUTER|case=GENITIVE	
ἡμετέρου	ἡμέτερος	ADJ	number=SINGULAR|gender=NEUTER|case=GENITIVE	
ὅθ̓	ὅτε	ADV	_	
ὑπὲρ	ὑπέρ	PREP	_	
Πύλου	Πύλος	NN	number=SINGULAR|gender=MASCULINE|case=GENITIVE	
ἠμαθόεντος	ἠμαθόεις	ADJ	number=SINGULAR|gender=MASCULINE|case=GENITIVE	
ἀντίος	ἀντίος	ADJ	number=SINGULAR|gender=MASCULINE|case=NOMINATIVE	
ἔστη	ἵστημι	VB	person=PERSON_3|number=SINGULAR|mood=INDICATIVE|voice=ACTIVE	
ἐμεῖο	ἐγώ	PRON	number=SINGULAR|gender=MASCULINE|case=GENITIVE	
μάχης	μάχη	NN	number=SINGULAR|gender=FEMININE|case=GENITIVE	
ἄμοτον	ἄμοτος	ADJ	number=SINGULAR|gender=NEUTER|case=ACCUSATIVE	
μενεαίνων	μενεαίνω	VB	number=SINGULAR|tense=PR|mood=PARTICIPLE|voice=ACTIVE|gender=MASCULINE|case=NOMINATIVE	
κείνων	ἐκεῖνος	ADJ	number=PLURAL|gender=MASCULINE|case=GENITIVE	
γὰρ	γάρ		_	
μεγάλη	μέγας	ADJ	number=SINGULAR|gender=FEMININE|case=NOMINATIVE	
τε	τε		_	
βίη	βία	NN	number=SINGULAR|gender=FEMININE|case=NOMINATIVE	
καὶ	καί	CONJ	_	
χεῖρες	χείρ	NN	number=PLURAL|gender=FEMININE|case=NOMINATIVE	
ἄαπτοι	ἄαπτος	ADJ	number=PLURAL|gender=FEMININE|case=NOMINATIVE	
ἐξ	ἐκ	PREP	_	
ὤμων	ὦμος	NN	number=PLURAL|gender=MASCULINE|case=GENITIVE	
ἐπέφυκον	φύω	VB	person=PERSON_3|number=PLURAL|mood=INDICATIVE|voice=ACTIVE	
ἐπὶ	ἐπί	PREP	_	
στιβαροῖσι	στιβαρός	ADJ	number=PLURAL|gender=NEUTER|case=DATIVE	
μέλεσσιν	μέλος	NN	number=PLURAL|gender=NEUTER|case=DATIVE	
ἦρχε	ἄρχω	VB	person=PERSON_3|number=SINGULAR|tense=IMP|mood=INDICATIVE|voice=ACTIVE	
δὲ	δέ		_	
τοῖσιν	ὁ	PRON	number=PLURAL|gender=MASCULINE|case=DATIVE	
ἐὺς	ἐύς	ADJ	number=SINGULAR|gender=MASCULINE|case=NOMINATIVE	
πάις	παῖς	NN	number=SINGULAR|gender=MASCULINE|case=NOMINATIVE	
Ἀλκαίοιο	Ἀλκαῖος	NN	number=SINGULAR|gender=MASCULINE|case=GENITIVE	
κυδιόων	κυδιάω	VB	number=SINGULAR|tense=PR|mood=PARTICIPLE|voice=ACTIVE|gender=MASCULINE|case=NOMINATIVE	
λαοῖσι	λαός	NN	number=PLURAL|gender=MASCULINE|case=DATIVE	
ἐν	ἐν	PREP	_	
γάρ	γάρ		_	
σφιν	σφεῖς	PRON	number=PLURAL|gender=MASCULINE|case=DATIVE	
μένος	μένος	NN	number=SINGULAR|gender=NEUTER|case=ACCUSATIVE	
ἧκε	ἵημι	VB	person=PERSON_3|number=SINGULAR|mood=INDICATIVE|voice=ACTIVE	
θεὰ	θεά	NN	number=SINGULAR|gender=FEMININE|case=NOMINATIVE	
γλαυκῶπις	γλαυκῶπις	ADJ	number=SINGULAR|gender=FEMININE|case=NOMINATIVE	
Ἀθήνη	Ἀθήνη	NN	number=SINGULAR|gender=FEMININE|case=NOMINATIVE	
αἰγίδ̓	αἰγίς	NN	number=SINGULAR|gender=FEMININE|case=ACCUSATIVE	
ἀνασσείσασα	ἀνασείω	VB	number=SINGULAR|mood=PARTICIPLE|voice=ACTIVE|gender=FEMININE|case=NOMINATIVE	
ἵκοντο	ἱκνέομαι	VB	person=PERSON_3|number=PLURAL|mood=INDICATIVE	
δὲ	δέ		_	
μακρὸν	μακρός	ADJ	number=SINGULAR|gender=MASCULINE|case=ACCUSATIVE	
Ὄλυμπον	Ὄλυμπος	NN	number=SINGULAR|gender=MASCULINE|case=ACCUSATIVE	
ὃ	ὁ	PRON	number=SINGULAR|gender=MASCULINE|case=NOMINATIVE	
γὰρ	γάρ		_	
δυνάμι	δύναμις	NN	number=SINGULAR|gender=FEMININE|case=DATIVE	
τε	τε		_	
καὶ	καί	CONJ	_	
αἰδοῖ	αἰδώς	NN	number=SINGULAR|gender=FEMININE|case=DATIVE	
Τρηχῖνος	Τραχίς	NN	number=SINGULAR|gender=FEMININE|case=GENITIVE	
προβέβηκε	προβαίνω	VB	person=PERSON_3|number=SINGULAR|tense=PERF|mood=INDICATIVE|voice=ACTIVE	
σὺ	σύ	PRON	number=SINGULAR|gender=MASCULINE|case=NOMINATIVE	
δ̓	δέ		_	
εὖ	εὖ	ADV	_	
μάλα	μάλα	ADV	_	
οἶσθα	εἴδω	VB	person=PERSON_2|number=SINGULAR|tense=PERF|mood=INDICATIVE|voice=ACTIVE	
καὶ	καί	ADV	_	
αὐτός	αὐτός	ADJ	number=SINGULAR|gender=MASCULINE|case=NOMINATIVE	
αὐτῇ	αὐτός	ADJ	number=SINGULAR|gender=FEMININE|case=DATIVE	
μὲν	μέν		_	
γὰρ	γάρ		_	
νυκτὶ	νύξ	NN	number=SINGULAR|gender=FEMININE|case=DATIVE	
τανυσφύρου	τανύσφυρος	ADJ	number=SINGULAR|gender=FEMININE|case=GENITIVE	
Ἠλεκτρυώνης	Ἠλεκτρυώνης	NN	number=SINGULAR|gender=FEMININE|case=GENITIVE	
εὐνῇ	εὐνή	NN	number=SINGULAR|gender=FEMININE|case=DATIVE	
καὶ	καί	CONJ	_	
φιλότητι	φιλότης	NN	number=SINGULAR|gender=FEMININE|case=DATIVE	
μίγη	μίγνυμι	VB	person=PERSON_3|number=SINGULAR|mood=INDICATIVE|voice=PASSIVE	
τέλεσεν	τελέω	VB	person=PERSON_3|number=SINGULAR|mood=INDICATIVE|voice=ACTIVE	
δ̓	δέ		_	
ἄῤ	ἄρα		_	
ἐέλδωρ	ἔλδωρ	NN	number=SINGULAR|gender=NEUTER|case=ACCUSATIVE	
τοῖσιν	ὁ	PRON	number=PLURAL|gender=MASCULINE|case=DATIVE	
δὲ	δέ		_	
προέκειτο	πρόκειμαι	VB	person=PERSON_3|number=SINGULAR|tense=IMP|mood=INDICATIVE	
μέγας	μέγας	ADJ	number=SINGULAR|gender=MASCULINE|case=NOMINATIVE	
τρίπος	τρίπους	NN	number=SINGULAR|gender=MASCULINE|case=NOMINATIVE	
ἐντὸς	ἐντός	PREP	_	
ἀγῶνος	ἀγών	NN	number=SINGULAR|gender=MASCULINE|case=GENITIVE	
χρύσειος	χρύσεος	ADJ	number=SINGULAR|gender=MASCULINE|case=NOMINATIVE	
κλυτὰ	κλυτός	ADJ	number=PLURAL|gender=NEUTER|case=NOMINATIVE	
ἔργα	ἔργον	NN	number=PLURAL|gender=NEUTER|case=NOMINATIVE	
περίφρονος	περίφρων	NN	number=SINGULAR|gender=MASCULINE|case=GENITIVE	
Ἡφαίστοιο	Ἥφαιστος	NN	number=SINGULAR|gender=MASCULINE|case=GENITIVE	
ἄλλο	ἄλλος	ADJ	number=SINGULAR|gender=NEUTER|case=ACCUSATIVE	
δὲ	δέ		_	
τοί	σύ	PRON	number=SINGULAR|gender=MASCULINE|case=DATIVE	
τι	τις	PRON	number=SINGULAR|gender=NEUTER|case=ACCUSATIVE	
ἔπος	ἔπος	NN	number=SINGULAR|gender=NEUTER|case=ACCUSATIVE	
ἐρέω	ἐρῶ	VB	person=PERSON_1|number=SINGULAR|tense=FUTURE|mood=INDICATIVE|voice=ACTIVE	
μέγα	μέγας	ADJ	number=SINGULAR|gender=NEUTER|case=ACCUSATIVE	
φέρτατε	φέρτατος	ADJ	number=SINGULAR|gender=MASCULINE|case=VOCATIVE|degree=SUPERLATIVE	
λαῶν	λαός	NN	number=PLURAL|gender=MASCULINE|case=GENITIVE	
οἳ	ὁ	PRON	number=PLURAL|gender=MASCULINE|case=NOMINATIVE	
δ̓	δέ		_	
ἀλαλητῷ	ἀλαλητός	NN	number=SINGULAR|gender=MASCULINE|case=DATIVE	
θεσπεσίῳ	θεσπέσιος	ADJ	number=SINGULAR|gender=MASCULINE|case=DATIVE	
σύνισαν	σύνειμι	VB	person=PERSON_3|number=PLURAL|tense=IMP|mood=INDICATIVE|voice=ACTIVE	
ὦρτο	ὄρνυμι	VB	person=PERSON_3|number=SINGULAR|mood=INDICATIVE	
δ̓	δέ		_	
ἀπ̓	ἀπό	PREP	_	
Οὐλύμποιο	Ὄλυμπος	NN	number=SINGULAR|gender=MASCULINE|case=GENITIVE	
δόλον	δόλος	NN	number=SINGULAR|gender=MASCULINE|case=ACCUSATIVE	
φρεσὶ	φρήν	NN	number=PLURAL|gender=FEMININE|case=DATIVE	
βυσσοδομεύων	βυσσοδομεύω	VB	number=SINGULAR|tense=PR|mood=PARTICIPLE|voice=ACTIVE|gender=MASCULINE|case=NOMINATIVE	
ἱμείρων	ἱμείρω	VB	number=SINGULAR|tense=PR|mood=PARTICIPLE|voice=ACTIVE|gender=MASCULINE|case=NOMINATIVE	
φιλότητος	φιλότης	NN	number=SINGULAR|gender=FEMININE|case=GENITIVE	
ἐυζώνοιο	εὔζωνος	ADJ	number=SINGULAR|gender=FEMININE|case=GENITIVE	
γυναικός	γυνή	NN	number=SINGULAR|gender=FEMININE|case=GENITIVE	
ἐννύχιος	ἐννύχιος	ADJ	number=SINGULAR|gender=FEMININE|case=NOMINATIVE	
τῶν	ὁ	PRON	number=PLURAL|gender=MASCULINE|case=GENITIVE	
ἵπποι	ἵππος	NN	number=PLURAL|gender=MASCULINE|case=NOMINATIVE	
μὲν	μέν		_	
ἔπειθ̓	ἔπειτα	ADV	_	
ὑπεναντίοι	ὑπεναντίος	ADJ	number=PLURAL|gender=MASCULINE|case=NOMINATIVE	
ἀλλήλοισιν	ἀλλήλων	ADJ	number=PLURAL|gender=MASCULINE|case=DATIVE	
ὀξεῖα	ὀξύς	ADJ	number=PLURAL|gender=NEUTER|case=ACCUSATIVE	
χρέμισαν	χρεμετίζω	VB	person=PERSON_3|number=PLURAL|mood=INDICATIVE|voice=ACTIVE	
περὶ	περί	PREP	_	
δέ	δέ		_	
σφισιν	σφεῖς	PRON	number=PLURAL|gender=MASCULINE|case=DATIVE	
ἄγνυτο	ἄγνυμι	VB	person=PERSON_3|number=SINGULAR|tense=IMP|mood=INDICATIVE	
ἠχώ	ἠχώ	NN	number=SINGULAR|gender=FEMININE|case=NOMINATIVE	
μάλα	μάλα	ADV	_	
γάρ	γάρ		_	
νύ	νῦν	ADV	_	
οἱ	ἕ	PRON	number=SINGULAR|gender=MASCULINE|case=DATIVE	
ἄρμενα	ἀραρίσκω	VB	number=PLURAL|mood=PARTICIPLE|gender=NEUTER|case=ACCUSATIVE	
εἶπεν	εἶπον	VB	person=PERSON_3|number=SINGULAR|mood=INDICATIVE|voice=ACTIVE	
αἳ	ὁ	PRON	number=PLURAL|gender=FEMININE|case=NOMINATIVE	
δ̓	δέ		_	
ὑπὸ	ὑπό	PREP	_	
φορμίγγων	φόρμιγξ	NN	number=PLURAL|gender=FEMININE|case=GENITIVE	
ἄναγον	ἀνάγω	VB	person=PERSON_3|number=PLURAL|tense=IMP|mood=INDICATIVE|voice=ACTIVE	
χορὸν	χορός	NN	number=SINGULAR|gender=MASCULINE|case=ACCUSATIVE	
ἱμερόεντα	ἱμερόεις	ADJ	number=SINGULAR|gender=MASCULINE|case=ACCUSATIVE	
ἐυπλεκέων	ἐυπλεκής	ADJ	number=PLURAL|gender=MASCULINE|case=GENITIVE	
δ̓	δέ		_	
ἐπὶ	ἐπί	PREP	_	
δίφρων	δίφρος	NN	number=PLURAL|gender=MASCULINE|case=GENITIVE	
ἡνίοχοι	ἡνίοχος	NN	number=PLURAL|gender=MASCULINE|case=NOMINATIVE	
βεβαῶτες	βαίνω	VB	number=PLURAL|tense=PERF|mood=PARTICIPLE|voice=ACTIVE|gender=MASCULINE|case=NOMINATIVE	
ἐφίεσαν	ἐφίημι	VB	person=PERSON_3|number=PLURAL|tense=IMP|mood=INDICATIVE|voice=ACTIVE	
ὠκέας	ὠκύς	ADJ	number=PLURAL|gender=MASCULINE|case=ACCUSATIVE	
ἵππους	ἵππος	NN	number=PLURAL|gender=MASCULINE|case=ACCUSATIVE	
ῥυτὰ	ῥυτόν	NN	number=PLURAL|gender=NEUTER|case=ACCUSATIVE	
χαλαίνοντες	χαλαίνω	VB	number=PLURAL|tense=PR|mood=PARTICIPLE|voice=ACTIVE|gender=MASCULINE|case=NOMINATIVE	
τὰ	ὁ		number=PLURAL|gender=NEUTER|case=NOMINATIVE	
δ̓	δέ		_	
ἐπικροτέοντα	ἐπικροτέω	VB	number=PLURAL|tense=PR|mood=PARTICIPLE|voice=ACTIVE|gender=NEUTER|case=NOMINATIVE	
πέτοντο	πέτομαι	VB	person=PERSON_3|number=PLURAL|tense=IMP|mood=INDICATIVE	
ἅρματα	ἅρμα	NN	number=PLURAL|gender=NEUTER|case=NOMINATIVE	
κολλήεντ̓	κολλήεις	ADJ	number=PLURAL|gender=NEUTER|case=NOMINATIVE	
ἐπὶ	ἐπί	PREP	_	
δὲ	δέ		_	
πλῆμναι	πλήμνη	NN	number=PLURAL|gender=FEMININE|case=NOMINATIVE	
μέγ̓	μέγας	ADJ	number=SINGULAR|gender=NEUTER|case=ACCUSATIVE	
ἀύτευν	ἀυτέω	VB	person=PERSON_3|number=PLURAL|tense=IMP|mood=INDICATIVE|voice=ACTIVE	
ὣς	ὡς	ADV	_	
ἔριπ̓	ἐρείπω	VB	person=PERSON_3|number=SINGULAR|mood=INDICATIVE|voice=ACTIVE	
ἀμφὶ	ἀμφί	PREP	_	
δὲ	δέ		_	
ποσσὶν	πούς	NN	number=PLURAL|gender=MASCULINE|case=DATIVE	
ἔχεν	ἔχω	VB	person=PERSON_3|number=SINGULAR|tense=IMP|mood=INDICATIVE|voice=ACTIVE	
πτερόεντα	πτερόεις	ADJ	number=PLURAL|gender=NEUTER|case=ACCUSATIVE	
πέδιλα	πέδιλον	NN	number=PLURAL|gender=NEUTER|case=ACCUSATIVE	
τὸν	ὁ	PRON	number=SINGULAR|gender=MASCULINE|case=ACCUSATIVE	
δ̓	δέ		_	
ἐπιόντα	ἔπειμι	VB	number=SINGULAR|tense=PR|mood=PARTICIPLE|voice=ACTIVE|gender=MASCULINE|case=ACCUSATIVE	
Ἀμφιτρυωνιάδης	Ἀμφιτρυωνιάδας	NN	number=SINGULAR|gender=MASCULINE|case=NOMINATIVE	
δεινῆς	δεινός	ADJ	number=SINGULAR|gender=FEMININE|case=GENITIVE	
ἀκόρητος	ἀκόρητος	ADJ	number=SINGULAR|gender=MASCULINE|case=NOMINATIVE	
ἀυτῆς	ἀυτή	NN	number=SINGULAR|gender=FEMININE|case=GENITIVE	
μηρὸν	μηρός	NN	number=SINGULAR|gender=MASCULINE|case=ACCUSATIVE	
γυμνωθέντα	γυμνόω	VB	number=SINGULAR|mood=PARTICIPLE|voice=PASSIVE|gender=MASCULINE|case=ACCUSATIVE	
σάκευς	σάκος	NN	number=SINGULAR|gender=NEUTER|case=GENITIVE	
ὕπο	ὑπό	PREP	_	
δαιδαλέοιο	δαιδάλεος	ADJ	number=SINGULAR|gender=NEUTER|case=GENITIVE	
οὔτασ̓	οὐτάζω	VB	person=PERSON_3|number=SINGULAR|mood=INDICATIVE|voice=ACTIVE	
ἐπικρατέως	ἐπικρατής	ADV	_	
ἀλλά	ἀλλά	CONJ	_	
οἱ	ἕ	PRON	number=SINGULAR|gender=MASCULINE|case=DATIVE	
εὐχωλέων	εὐχωλή	NN	number=PLURAL|gender=FEMININE|case=GENITIVE	
οὐκ	οὐ	ADV	_	
ἔκλυε	κλύω	VB	person=PERSON_3|number=SINGULAR|mood=INDICATIVE|voice=ACTIVE	
Φοῖβος	Φοῖβος	NN	number=SINGULAR|gender=MASCULINE|case=NOMINATIVE	
Ἀπόλλων	Ἀπόλλων	NN	number=SINGULAR|gender=MASCULINE|case=NOMINATIVE	
ἐν	ἐν	PREP	_	
δὲ	δέ		_	
Διὸς	Ζεύς	NN	number=SINGULAR|gender=MASCULINE|case=GENITIVE	
θυγάτηρ	θυγάτηρ	NN	number=SINGULAR|gender=FEMININE|case=NOMINATIVE	
ἀγελείη	ἀγελείη	NN	number=SINGULAR|gender=FEMININE|case=NOMINATIVE	
Τριτογένεια	Τριτογένεια	NN	number=SINGULAR|gender=FEMININE|case=NOMINATIVE	
τῇ	ὁ	PRON	number=SINGULAR|gender=FEMININE|case=DATIVE	
ἰκέλη	ἴκελος	ADJ	number=SINGULAR|gender=FEMININE|case=NOMINATIVE	
ὡς	ὡς	ADV	_	
εἴ	εἰ	CONJ	_	
τε	τε		_	
μάχην	μάχη	NN	number=SINGULAR|gender=FEMININE|case=ACCUSATIVE	
ἐθέλουσα	ἐθέλω	VB	number=SINGULAR|tense=PR|mood=PARTICIPLE|voice=ACTIVE|gender=FEMININE|case=NOMINATIVE	
κορύσσειν	κορύσσω	VB	tense=PR|mood=INFINITIVE|voice=ACTIVE	
ἔγχος	ἔγχος	NN	number=SINGULAR|gender=NEUTER|case=ACCUSATIVE	
ἔχουσ̓	ἔχω	VB	number=SINGULAR|tense=PR|mood=PARTICIPLE|voice=ACTIVE|gender=FEMININE|case=NOMINATIVE	
ἐν	ἐν	PREP	_	
χερσὶν	χείρ	NN	number=PLURAL|gender=FEMININE|case=DATIVE	
ἰδὲ	ἰδέ	CONJ	_	
χρυσέην	χρύσεος	ADJ	number=SINGULAR|gender=FEMININE|case=ACCUSATIVE	
τρυφάλειαν	τρυφάλεια	NN	number=SINGULAR|gender=FEMININE|case=ACCUSATIVE	
αἰγίδα	αἰγίς	NN	number=SINGULAR|gender=FEMININE|case=ACCUSATIVE	
τ̓	τε		_	
ἀμφ̓	ἀμφί	PREP	_	
ὤμοις	ὦμος	NN	number=PLURAL|gender=MASCULINE|case=DATIVE	
καί	καί	CONJ	_	
τε	τε		_	
συναΐγδην	συναίγδην	ADV	_	
ὡς	ὡς	ADV	_	
εἰ	εἰ	CONJ	_	
ζωοί	ζωός	ADJ	number=PLURAL|gender=MASCULINE|case=NOMINATIVE	
περ	πέρ		_	
ἐόντες	εἰμί	VB	number=PLURAL|tense=PR|mood=PARTICIPLE|voice=ACTIVE|gender=MASCULINE|case=NOMINATIVE	
ἔγχεσιν	ἔγχος	NN	number=PLURAL|gender=NEUTER|case=DATIVE	
ἠδ̓	ἠδέ	CONJ	_	
ἐλάτῃς	ἐλάτη	NN	number=PLURAL|gender=FEMININE|case=DATIVE	
αὐτοσχεδὸν	αὐτοσχεδόν	ADV	_	
ὠριγνῶντο	ὀριγνάομαι	VB	person=PERSON_3|number=PLURAL|tense=IMP|mood=INDICATIVE	
τῶν	ὁ	PRON	number=PLURAL|gender=MASCULINE|case=GENITIVE	
ὅ	ὁ	PRON	number=SINGULAR|gender=MASCULINE|case=NOMINATIVE	
γ̓	γε		_	
ὀπίζετο	ὀπίζομαι	VB	person=PERSON_3|number=SINGULAR|tense=IMP|mood=INDICATIVE	
μῆνιν	μῆνις	NN	number=SINGULAR|gender=FEMININE|case=ACCUSATIVE	
ἐπείγετο	ἐπείγω	VB	person=PERSON_3|number=SINGULAR|tense=IMP|mood=INDICATIVE	
δ̓	δέ		_	
ὅττι	ὅτι	CONJ	_	
τάχιστα	ταχύς	ADJ	number=PLURAL|gender=NEUTER|case=ACCUSATIVE	
ἐκτελέσαι	ἐκτελέω	VB	mood=INFINITIVE|voice=ACTIVE	
μέγα	μέγας	ADJ	number=SINGULAR|gender=NEUTER|case=ACCUSATIVE	
ἔργον	ἔργον	NN	number=SINGULAR|gender=NEUTER|case=ACCUSATIVE	
ὅ	ὅς	PRON	number=SINGULAR|gender=NEUTER|case=NOMINATIVE	
οἱ	ἕ	PRON	number=SINGULAR|gender=MASCULINE|case=DATIVE	
Διόθεν	Διόθεν	ADV	_	
θέμις	θέμις	NN	number=SINGULAR|gender=FEMININE|case=NOMINATIVE	
ἦεν	εἰμί	VB	person=PERSON_3|number=SINGULAR|tense=IMP|mood=INDICATIVE|voice=ACTIVE	
λιπὼν	λείπω	VB	number=SINGULAR|mood=PARTICIPLE|voice=ACTIVE|gender=MASCULINE|case=NOMINATIVE	
δ̓	δέ		_	
ὅ	ὁ	PRON	number=SINGULAR|gender=MASCULINE|case=NOMINATIVE	
γε	γε		_	
πατρίδα	πατρίς	ADJ	number=SINGULAR|gender=FEMININE|case=ACCUSATIVE	
γαῖαν	γαῖα	NN	number=SINGULAR|gender=FEMININE|case=ACCUSATIVE	
ἐς	εἰς	PREP	_	
Θήβας	Θῆβαι	NN	number=PLURAL|gender=FEMININE|case=ACCUSATIVE	
ἱκέτευσε	ἱκετεύω	VB	person=PERSON_3|number=SINGULAR|mood=INDICATIVE|voice=ACTIVE	
φερεσσακέας	φερεσσακής	ADJ	number=PLURAL|gender=MASCULINE|case=ACCUSATIVE	
Καδμείους	Καδμεῖος	ADJ	number=PLURAL|gender=MASCULINE|case=ACCUSATIVE	
δοιὼ	δοιώ	ADJ	gender=MASCULINE|case=NOMINATIVE	
δ̓	δέ		_	
ἀναφυσιόωντες	ἀναφυσιόω	VB	number=PLURAL|tense=PR|mood=PARTICIPLE|voice=ACTIVE|gender=MASCULINE|case=NOMINATIVE	
ἀργύρεοι	ἀργύρεος	ADJ	number=PLURAL|gender=MASCULINE|case=NOMINATIVE	
δελφῖνες	δελφίς	NN	number=PLURAL|gender=MASCULINE|case=NOMINATIVE	
ἐθοινῶντ̓	θοινάω	VB	person=PERSON_3|number=PLURAL|tense=IMP|mood=INDICATIVE	
ἔλλοπας	ἔλλοψ	NN	number=PLURAL|gender=MASCULINE|case=ACCUSATIVE	
ἰχθῦς	ἰχθύς	NN	number=PLURAL|gender=MASCULINE|case=ACCUSATIVE	
ὡς	ὡς	ADV	_	
δ̓	δέ		_	
ὅτ̓	ὅτε	CONJ	_	
ἀνὴρ	ἀνήρ	NN	number=SINGULAR|gender=MASCULINE|case=NOMINATIVE	
ἀσπαστὸν	ἀσπαστός	ADJ	number=SINGULAR|gender=NEUTER|case=ACCUSATIVE	
ὑπεκπροφύγῃ	ὑπεκπροφεύγω	VB	person=PERSON_3|number=SINGULAR|mood=SUBJUNCTIVE|voice=ACTIVE	
κακότητα	κακότης	NN	number=SINGULAR|gender=FEMININE|case=ACCUSATIVE	
νούσου	νόσος	NN	number=SINGULAR|gender=FEMININE|case=GENITIVE	
ὕπ̓	ὑπό	PREP	_	
ἀργαλέης	ἀργαλέος	ADJ	number=SINGULAR|gender=FEMININE|case=GENITIVE	
ἢ	ἤ	CONJ	_	
καὶ	καί	ADV	_	
κρατεροῦ	κρατερός	ADJ	number=SINGULAR|gender=MASCULINE|case=GENITIVE	
ὑπὸ	ὑπό	PREP	_	
δεσμοῦ	δεσμός	NN	number=SINGULAR|gender=MASCULINE|case=GENITIVE	
ὥς	ὡς	ADV	_	
ῥα	ἄρα		_	
τότ̓	τότε	ADV	_	
Ἀμφιτρύων	Ἀμφιτρύων	NN	number=SINGULAR|gender=MASCULINE|case=NOMINATIVE	
χαλεπὸν	χαλεπός	ADJ	number=SINGULAR|gender=MASCULINE|case=ACCUSATIVE	
πόνον	πόνος	NN	number=SINGULAR|gender=MASCULINE|case=ACCUSATIVE	
ἐκτολυπεύσας	ἐκτολυπεύω	VB	number=SINGULAR|mood=PARTICIPLE|voice=ACTIVE|gender=MASCULINE|case=NOMINATIVE	
ἀσπασίως	ἀσπάσιος	ADV	_	
τε	τε		_	
φίλως	φίλος	ADV	_	
τε	τε		_	
ἑὸν	ἑός	ADJ	number=SINGULAR|gender=MASCULINE|case=ACCUSATIVE	
δόμον	δόμος	NN	number=SINGULAR|gender=MASCULINE|case=ACCUSATIVE	
εἰσαφίκανεν	εἰσαφικάνω	VB	person=PERSON_3|number=SINGULAR|tense=IMP|mood=INDICATIVE|voice=ACTIVE	
ἣ	ὁ		number=SINGULAR|gender=FEMININE|case=NOMINATIVE	
μὲν	μέν		_	
ὑφήσσων	ὑφήσσων	ADJ	number=SINGULAR|gender=FEMININE|case=NOMINATIVE	
Ἀτροπος	Ἄτροπος	NN	number=SINGULAR|gender=FEMININE|case=NOMINATIVE	
οὔ	οὐ	ADV	_	
τι	τις	PRON	number=SINGULAR|gender=NEUTER|case=ACCUSATIVE	
πέλεν	πέλω	VB	person=PERSON_3|number=SINGULAR|tense=IMP|mood=INDICATIVE|voice=ACTIVE	
μεγάλη	μέγας	ADJ	number=SINGULAR|gender=FEMININE|case=NOMINATIVE	
θεός	θεός	NN	number=SINGULAR|gender=FEMININE|case=NOMINATIVE	
ἀλλ̓	ἀλλά	CONJ	_	
ἄρα	ἄρα		_	
ἥ	ὁ	PRON	number=SINGULAR|gender=FEMININE|case=NOMINATIVE	
γε	γε		_	
τῶν	ὁ		number=PLURAL|gender=FEMININE|case=GENITIVE	
γε	γε		_	
μὲν	μέν		_	
ἀλλάων	ἄλλος	ADJ	number=PLURAL|gender=FEMININE|case=GENITIVE	
προφερής	προφερής	ADJ	number=SINGULAR|gender=FEMININE|case=NOMINATIVE	
τ̓	τε		_	
ἦν	εἰμί	VB	person=PERSON_3|number=SINGULAR|tense=IMP|mood=INDICATIVE|voice=ACTIVE	
πρεσβυτάτη	πρέσβυς	ADJ	number=SINGULAR|gender=FEMININE|case=NOMINATIVE|degree=SUPERLATIVE	
τε	τε		_	
καί	καί	CONJ	_	
μιν	μιν	PRON	number=SINGULAR|gender=MASCULINE|case=ACCUSATIVE	
ἀμειβόμενος	ἀμείβω	VB	number=SINGULAR|tense=PR|mood=PARTICIPLE|gender=MASCULINE|case=NOMINATIVE	
ἔπεα	ἔπος	NN	number=PLURAL|gender=NEUTER|case=ACCUSATIVE	
πτερόεντα	πτερόεις	ADJ	number=PLURAL|gender=NEUTER|case=ACCUSATIVE	
προσηύδα	προσαυδάω	VB	person=PERSON_3|number=SINGULAR|tense=IMP|mood=INDICATIVE|voice=ACTIVE	
τῶν	ὁ	PRON	number=PLURAL|gender=MASCULINE|case=GENITIVE	
δ̓	δέ		_	
ὕπο	ὑπό	PREP	_	
χάλκειοι	χάλκειος	ADJ	number=PLURAL|gender=MASCULINE|case=NOMINATIVE	
τρέον	τρέω	VB	person=PERSON_3|number=PLURAL|tense=IMP|mood=INDICATIVE|voice=ACTIVE	
ἰχθύες	ἰχθύς	NN	number=PLURAL|gender=MASCULINE|case=NOMINATIVE	
ἥρως	ἥρως	NN	number=SINGULAR|gender=MASCULINE|case=VOCATIVE	
ὦ	ὦ		_	
Ἰόλαε	Ἰόλαος	NN	number=SINGULAR|gender=MASCULINE|case=VOCATIVE	
διοτρεφές	διοτρεφής	ADJ	number=SINGULAR|gender=NEUTER|case=VOCATIVE	
οὐκέτι	οὐκέτι	ADV	_	
τηλοῦ	τηλοῦ	ADV	_	
ὑσμίνη	ὑσμίνη	NN	number=SINGULAR|gender=FEMININE|case=NOMINATIVE	
τρηχεῖα	τραχύς	ADJ	number=SINGULAR|gender=FEMININE|case=NOMINATIVE	
χερσί	χείρ	NN	number=PLURAL|gender=FEMININE|case=DATIVE	
γε	γε		_	
μὴν	μήν		_	
σάκος	σάκος	NN	number=SINGULAR|gender=NEUTER|case=ACCUSATIVE	
εἷλε	αἱρέω	VB	person=PERSON_3|number=SINGULAR|mood=INDICATIVE|voice=ACTIVE	
παναίολον	παναίολος	ADJ	number=SINGULAR|gender=NEUTER|case=ACCUSATIVE	
οὐ	οὐ	ADV	_	
δέ	δέ		_	
τις	τις	PRON	number=SINGULAR|gender=MASCULINE|case=NOMINATIVE	
αὐτὸ	αὐτός	ADJ	number=SINGULAR|gender=NEUTER|case=ACCUSATIVE	
οὔ	οὐ	ADV	_	
τ̓	τε		_	
ἔρρηξε	ῥήγνυμι	VB	person=PERSON_3|number=SINGULAR|mood=INDICATIVE|voice=ACTIVE	
βαλὼν	βάλλω	VB	number=SINGULAR|mood=PARTICIPLE|voice=ACTIVE|gender=MASCULINE|case=NOMINATIVE	
οὔ	οὐ	ADV	_	
τ̓	τε		_	
ἔθλασε	θλάω	VB	person=PERSON_3|number=SINGULAR|mood=INDICATIVE|voice=ACTIVE	
θαῦμα	θαῦμα	NN	number=SINGULAR|gender=NEUTER|case=ACCUSATIVE	
ἰδέσθαι	εἶδον	VB	mood=INFINITIVE	
οἶον	οἶος	ADJ	number=SINGULAR|gender=MASCULINE|case=ACCUSATIVE	
δὴ	δή		_	
καὶ	καί	ADV	_	
τόνδε	ὅδε	PRON	number=SINGULAR|gender=MASCULINE|case=ACCUSATIVE	
βροτὸν	βροτός	NN	number=SINGULAR|gender=MASCULINE|case=ACCUSATIVE	
κρατερόν	κρατερός	ADJ	number=SINGULAR|gender=MASCULINE|case=ACCUSATIVE	
τε	τε		_	
μέγαν	μέγας	ADJ	number=SINGULAR|gender=MASCULINE|case=ACCUSATIVE	
τε	τε		_	
σὰς	σός	ADJ	number=PLURAL|gender=FEMININE|case=ACCUSATIVE	
ἐς	εἰς	PREP	_	
χεῖρας	χείρ	NN	number=PLURAL|gender=FEMININE|case=ACCUSATIVE	
ἄγουσιν	ἄγω	VB	person=PERSON_3|number=PLURAL|tense=PR|mood=INDICATIVE|voice=ACTIVE	
ἵνα	ἵνα	CONJ	_	
κλέος	κλέος	NN	number=SINGULAR|gender=NEUTER|case=ACCUSATIVE	
ἐσθλὸν	ἐσθλός	ADJ	number=SINGULAR|gender=NEUTER|case=ACCUSATIVE	
ἄρηαι	αἴρω	VB	person=PERSON_2|number=SINGULAR|mood=SUBJUNCTIVE	
γλαυκιόων	γλαυκιάω	VB	number=SINGULAR|tense=PR|mood=PARTICIPLE|voice=ACTIVE|gender=MASCULINE|case=NOMINATIVE	
δ̓	δέ		_	
ὄσσοις	ὄσσε	NN	number=PLURAL|gender=NEUTER|case=DATIVE	
δεινὸν	δεινός	ADJ	number=SINGULAR|gender=NEUTER|case=ACCUSATIVE	
πλευράς	πλευρά	NN	number=PLURAL|gender=FEMININE|case=ACCUSATIVE	
τε	τε		_	
καὶ	καί	CONJ	_	
ὤμους	ὦμος	NN	number=PLURAL|gender=MASCULINE|case=ACCUSATIVE	
οὐρῇ	οὐρά	NN	number=SINGULAR|gender=FEMININE|case=DATIVE	
μαστιόων	μαστιάω	VB	number=SINGULAR|tense=PR|mood=PARTICIPLE|voice=ACTIVE|gender=MASCULINE|case=NOMINATIVE	
ποσσὶν	πούς	NN	number=PLURAL|gender=MASCULINE|case=DATIVE	
γλάφει	γλάφω	VB	person=PERSON_3|number=SINGULAR|tense=PR|mood=INDICATIVE|voice=ACTIVE	
οὐ	οὐ	ADV	_	
δέ	δέ		_	
τις	τις	PRON	number=SINGULAR|gender=MASCULINE|case=NOMINATIVE	
αὐτὸν	αὐτός	ADJ	number=SINGULAR|gender=MASCULINE|case=ACCUSATIVE	
ἔτλη	τλάω	VB	person=PERSON_3|number=SINGULAR|mood=INDICATIVE|voice=ACTIVE	
ἐς	εἰς	PREP	_	
ἄντα	ἄντα	ADV	_	
ἰδὼν	εἶδον	VB	number=SINGULAR|mood=PARTICIPLE|voice=ACTIVE|gender=MASCULINE|case=NOMINATIVE	
σχεδὸν	σχεδόν	ADV	_	
ἐλθέμεν	ἔρχομαι	VB	mood=INFINITIVE|voice=ACTIVE	
οὐ	οὐ	ADV	_	
δὲ	δέ		_	
μάχεσθαι	μάχομαι	VB	tense=PR|mood=INFINITIVE	
αὐτὰρ	ἀτάρ	CONJ	_	
Ἀθηναίη	Ἀθήνη	NN	number=SINGULAR|gender=FEMININE|case=NOMINATIVE	
κούρη	κόρη	NN	number=SINGULAR|gender=FEMININE|case=NOMINATIVE	
Διὸς	Ζεύς	NN	number=SINGULAR|gender=MASCULINE|case=GENITIVE	
αἰγιόχοιο	αἰγίοχος	ADJ	number=SINGULAR|gender=MASCULINE|case=GENITIVE	
ἀντίη	ἀντίος	ADJ	number=SINGULAR|gender=FEMININE|case=NOMINATIVE	
ἦλθεν	ἔρχομαι	VB	person=PERSON_3|number=SINGULAR|mood=INDICATIVE|voice=ACTIVE	
Ἄρηος	Ἄρης	NN	number=SINGULAR|gender=MASCULINE|case=GENITIVE	
ἐρεμνὴν	ἐρεμνός	ADJ	number=SINGULAR|gender=FEMININE|case=ACCUSATIVE	
αἰγίδ̓	αἰγίς	NN	number=SINGULAR|gender=FEMININE|case=ACCUSATIVE	
ἔχουσα	ἔχω	VB	number=SINGULAR|tense=PR|mood=PARTICIPLE|voice=ACTIVE|gender=FEMININE|case=NOMINATIVE	
αἶψα	αἶψα	ADV	_	
δ̓	δέ		_	
ἔπειτα	ἔπειτα	ADV	_	
πόλιν	πόλις	NN	number=SINGULAR|gender=FEMININE|case=ACCUSATIVE	
Τρηχῖνος	Τραχίς	NN	number=SINGULAR|gender=FEMININE|case=GENITIVE	
ἵκοντο	ἱκνέομαι	VB	person=PERSON_3|number=PLURAL|mood=INDICATIVE	
ἵπποις	ἵππος	NN	number=PLURAL|gender=MASCULINE|case=DATIVE	
ὠκυπόδεσσιν	ὠκύπους	NN	number=PLURAL|gender=MASCULINE|case=DATIVE	
τοῦ	ὁ	PRON	number=SINGULAR|gender=MASCULINE|case=GENITIVE	
μὲν	μέν		_	
φρένας	φρήν	NN	number=PLURAL|gender=FEMININE|case=ACCUSATIVE	
ἐξέλετο	ἐξαιρέω	VB	person=PERSON_3|number=SINGULAR|mood=INDICATIVE	
Ζεύς	Ζεύς	NN	number=SINGULAR|gender=MASCULINE|case=NOMINATIVE	
ὃς	ὅς	PRON	number=SINGULAR|gender=MASCULINE|case=NOMINATIVE	
προλιπὼν	προλείπω	VB	number=SINGULAR|mood=PARTICIPLE|voice=ACTIVE|gender=MASCULINE|case=NOMINATIVE	
σφέτερον	σφέτερος	ADJ	number=SINGULAR|gender=MASCULINE|case=ACCUSATIVE	
τε	τε		_	
δόμον	δόμος	NN	number=SINGULAR|gender=MASCULINE|case=ACCUSATIVE	
σφετέρους	σφέτερος	ADJ	number=PLURAL|gender=MASCULINE|case=ACCUSATIVE	
τε	τε		_	
τοκῆας	τοκεύς	NN	number=PLURAL|gender=MASCULINE|case=ACCUSATIVE	
ᾤχετο	οἴχομαι	VB	person=PERSON_3|number=SINGULAR|tense=IMP|mood=INDICATIVE	
τιμήσων	τιμάω	VB	number=SINGULAR|tense=FUTURE|mood=PARTICIPLE|voice=ACTIVE|gender=MASCULINE|case=NOMINATIVE	
ἀλιτήμενον	ἀλιταίνω	VB	number=SINGULAR|tense=PR|mood=PARTICIPLE|gender=MASCULINE|case=ACCUSATIVE	
Εὐρυσθῆα	Εὐρυσθεύς	NN	number=SINGULAR|gender=MASCULINE|case=ACCUSATIVE	
σχέτλιος	σχέτλιος	ADJ	number=SINGULAR|gender=MASCULINE|case=NOMINATIVE	
ἀμφὶ	ἀμφί	PREP	_	
δ̓	δέ		_	
ἴτυν	ἴτυς	NN	number=SINGULAR|gender=FEMININE|case=ACCUSATIVE	
ῥέεν	ῥέω	VB	person=PERSON_3|number=SINGULAR|tense=IMP|mood=INDICATIVE|voice=ACTIVE	
Ὠκεανὸς	Ὠκεανός	NN	number=SINGULAR|gender=MASCULINE|case=NOMINATIVE	
πλήθοντι	πλήθω	VB	number=SINGULAR|tense=PR|mood=PARTICIPLE|voice=ACTIVE|gender=MASCULINE|case=DATIVE	
ἐοικώς	ἔοικα	VB	number=SINGULAR|tense=PERF|mood=PARTICIPLE|voice=ACTIVE|gender=MASCULINE|case=NOMINATIVE	
πᾶν	πᾶς	ADJ	number=SINGULAR|gender=NEUTER|case=ACCUSATIVE	
δὲ	δέ		_	
συνεῖχε	συνέχω	VB	person=PERSON_3|number=SINGULAR|tense=IMP|mood=INDICATIVE|voice=ACTIVE	
σάκος	σάκος	NN	number=SINGULAR|gender=NEUTER|case=ACCUSATIVE	
πολυδαίδαλον	πολυδαίδαλος	ADJ	number=SINGULAR|gender=NEUTER|case=ACCUSATIVE	
οἳ	ὁ	PRON	number=PLURAL|gender=MASCULINE|case=NOMINATIVE	
δὲ	δέ		_	
κατ̓	κατά	PREP	_	
αὐτὸν	αὐτός	ADJ	number=SINGULAR|gender=MASCULINE|case=ACCUSATIVE	
κύκνοι	κύκνος	NN	number=PLURAL|gender=MASCULINE|case=NOMINATIVE	
ἀερσιπόται	ἀερσιπότης	NN	number=PLURAL|gender=MASCULINE|case=NOMINATIVE	
μεγάλ̓	μέγας	ADJ	number=PLURAL|gender=NEUTER|case=ACCUSATIVE	
ἤπυον	ἠπύω	VB	person=PERSON_3|number=PLURAL|tense=IMP|mood=INDICATIVE|voice=ACTIVE	
οἵ	ὅς	PRON	number=PLURAL|gender=MASCULINE|case=NOMINATIVE	
ῥά	ἄρα		_	
τε	τε		_	
πολλοὶ	πολύς	ADJ	number=PLURAL|gender=MASCULINE|case=NOMINATIVE	
νῆχον	νήχω	VB	person=PERSON_3|number=PLURAL|tense=IMP|mood=INDICATIVE|voice=ACTIVE	
ἐπ̓	ἐπί	PREP	_	
ἄκρον	ἄκρος	ADJ	number=SINGULAR|gender=NEUTER|case=ACCUSATIVE	
ὕδωρ	ὕδωρ	NN	number=SINGULAR|gender=NEUTER|case=ACCUSATIVE	
ἐν	ἐν	PREP	_	
δ̓	δέ		_	
ὀφίων	ὄφις	NN	number=PLURAL|gender=FEMININE|case=GENITIVE	
κεφαλαὶ	κεφαλή	NN	number=PLURAL|gender=FEMININE|case=NOMINATIVE	
δεινῶν	δεινός	ADJ	number=PLURAL|gender=FEMININE|case=GENITIVE	
ἔσαν	εἰμί	VB	person=PERSON_3|number=PLURAL|tense=IMP|mood=INDICATIVE|voice=ACTIVE	
οὔ	οὐ	ADV	_	
τι	τις	PRON	number=SINGULAR|gender=NEUTER|case=ACCUSATIVE	
φατειῶν	φατειός	ADJ	number=PLURAL|gender=FEMININE|case=GENITIVE	
δώδεκα	δώδεκα	NRL	_	
ταὶ	ὁ	PRON	number=PLURAL|gender=FEMININE|case=NOMINATIVE	
φοβέεσκον	φοβέω	VB	person=PERSON_3|number=PLURAL|tense=IMP|mood=INDICATIVE|voice=ACTIVE	
ἐπὶ	ἐπί	PREP	_	
χθονὶ	χθών	NN	number=SINGULAR|gender=FEMININE|case=DATIVE	
φῦλ̓	φῦλον	NN	number=PLURAL|gender=NEUTER|case=ACCUSATIVE	
ἀνθρώπων	ἄνθρωπος	NN	number=PLURAL|gender=MASCULINE|case=GENITIVE	
οἵ	ὅς	PRON	number=PLURAL|gender=MASCULINE|case=NOMINATIVE	
τινες	τις	PRON	number=PLURAL|gender=MASCULINE|case=NOMINATIVE	
ἀντιβίην	ἀντιβίην	ADV	_	
πόλεμον	πόλεμος	NN	number=SINGULAR|gender=MASCULINE|case=ACCUSATIVE	
Διὸς	Ζεύς	NN	number=SINGULAR|gender=MASCULINE|case=GENITIVE	
υἷι	υἱός	NN	number=SINGULAR|gender=MASCULINE|case=DATIVE	
φέροιεν	φέρω	VB	person=PERSON_3|number=PLURAL|tense=PR|voice=ACTIVE	
οὐ	οὐ	ADV	_	
γάρ	γάρ		_	
τοι	σύ	PRON	number=SINGULAR|gender=MASCULINE|case=DATIVE	
θέμις	θέμις	NN	number=SINGULAR|gender=FEMININE|case=NOMINATIVE	
ἐστὶν	εἰμί	VB	person=PERSON_3|number=SINGULAR|tense=PR|mood=INDICATIVE|voice=ACTIVE	
ἀπὸ	ἀπό	PREP	_	
κλυτὰ	κλυτός	ADJ	number=PLURAL|gender=NEUTER|case=ACCUSATIVE	
τεύχεα	τεῦχος	NN	number=PLURAL|gender=NEUTER|case=ACCUSATIVE	
δῦσαι	δύω	VB	mood=INFINITIVE|voice=ACTIVE	
Ἡρακλέα	Ἡρακλέης	NN	number=SINGULAR|gender=MASCULINE|case=ACCUSATIVE	
κτείναντα	κτείνω	VB	number=SINGULAR|mood=PARTICIPLE|voice=ACTIVE|gender=MASCULINE|case=ACCUSATIVE	
Διὸς	Ζεύς	NN	number=SINGULAR|gender=MASCULINE|case=GENITIVE	
θρασυκάρδιον	θρασυκάρδιος	ADJ	number=SINGULAR|gender=MASCULINE|case=ACCUSATIVE	
υἱόν	υἱός	NN	number=SINGULAR|gender=MASCULINE|case=ACCUSATIVE	
δὴ	δή		_	
τότ̓	τότε	ADV	_	
ἀπ̓	ἀπό	PREP	_	
εὐπλεκέων	εὐπλεκής	ADJ	number=PLURAL|gender=MASCULINE|case=GENITIVE	
δίφρων	δίφρος	NN	number=PLURAL|gender=MASCULINE|case=GENITIVE	
θόρον	θρῴσκω	VB	person=PERSON_3|number=PLURAL|mood=INDICATIVE|voice=ACTIVE	
αἶψ̓	αἶψα	ADV	_	
ἐπὶ	ἐπί	PREP	_	
γαῖαν	γαῖα	NN	number=SINGULAR|gender=FEMININE|case=ACCUSATIVE	
παῖς	παῖς	NN	number=SINGULAR|gender=MASCULINE|case=NOMINATIVE	
τε	τε		_	
Διὸς	Ζεύς	NN	number=SINGULAR|gender=MASCULINE|case=GENITIVE	
μεγάλου	μέγας	ADJ	number=SINGULAR|gender=MASCULINE|case=GENITIVE	
καὶ	καί	CONJ	_	
Ἐνυαλίοιο	Ἐνυάλιος	NN	number=SINGULAR|gender=MASCULINE|case=GENITIVE	
ἄνακτος	ἄναξ	NN	number=SINGULAR|gender=MASCULINE|case=GENITIVE	
τὸν	ὁ	PRON	number=SINGULAR|gender=MASCULINE|case=ACCUSATIVE	
δ̓	δέ		_	
αὖτε	αὖτε	ADV	_	
προσέειπεν	προσεῖπον	VB	person=PERSON_3|number=SINGULAR|mood=INDICATIVE|voice=ACTIVE	
ἀμώμητος	ἀμώμητος	ADJ	number=SINGULAR|gender=MASCULINE|case=NOMINATIVE	
Ἰόλαος	Ἰόλαος	NN	number=SINGULAR|gender=MASCULINE|case=NOMINATIVE	
νῦν	νῦν	ADV	_	
δὴ	δή		_	
Ζεὺς	Ζεύς	NN	number=SINGULAR|gender=MASCULINE|case=NOMINATIVE	
κράτος	κράτος	NN	number=SINGULAR|gender=NEUTER|case=ACCUSATIVE	
ὔμμι	σύ	PRON	number=PLURAL|gender=MASCULINE|case=DATIVE	
διδοῖ	δίδωμι	VB	person=PERSON_3|number=SINGULAR|tense=PR|mood=INDICATIVE|voice=ACTIVE	
μακάρεσσιν	μάκαρ	NN	number=PLURAL|gender=MASCULINE|case=DATIVE	
ἀνάσσων	ἀνάσσω	VB	number=SINGULAR|tense=PR|mood=PARTICIPLE|voice=ACTIVE|gender=MASCULINE|case=NOMINATIVE	
Κύκνον	Κύκνος	NN	number=SINGULAR|gender=MASCULINE|case=ACCUSATIVE	
τ̓	τε		_	
ἐξεναρεῖν	ἐξεναίρω	VB	mood=INFINITIVE|voice=ACTIVE	
καὶ	καί	CONJ	_	
ἀπὸ	ἀπό	PREP	_	
κλυτὰ	κλυτός	ADJ	number=PLURAL|gender=NEUTER|case=ACCUSATIVE	
τεύχεα	τεῦχος	NN	number=PLURAL|gender=NEUTER|case=ACCUSATIVE	
δῦσαι	δύω	VB	mood=INFINITIVE|voice=ACTIVE	
τοὶ	ὁ	PRON	number=PLURAL|gender=MASCULINE|case=NOMINATIVE	
δ̓	δέ		_	
ἄμυδις	ἄμυδις	ADV	_	
προγένοντ̓	προγίγνομαι	VB	person=PERSON_3|number=PLURAL|mood=INDICATIVE	
ἴκελοι	ἴκελος	ADJ	number=PLURAL|gender=MASCULINE|case=NOMINATIVE	
πυρὶ	πῦρ	NN	number=SINGULAR|gender=NEUTER|case=DATIVE	
ἠὲ	ἤ	CONJ	_	
θυέλλῃ	θύελλα	NN	number=SINGULAR|gender=FEMININE|case=DATIVE	
Κύκνος	Κύκνος	NN	number=SINGULAR|gender=MASCULINE|case=NOMINATIVE	
θ̓	τε		_	
ἱππόδαμος	ἱππόδαμος	ADJ	number=SINGULAR|gender=MASCULINE|case=NOMINATIVE	
καὶ	καί	CONJ	_	
Ἄρης	Ἄρης	NN	number=SINGULAR|gender=MASCULINE|case=NOMINATIVE	
ἀκόρητος	ἀκόρητος	ADJ	number=SINGULAR|gender=MASCULINE|case=NOMINATIVE	
ἀυτῆς	ἀυτή	NN	number=SINGULAR|gender=FEMININE|case=GENITIVE	
ὡς	ὡς	ADV	_	
δ̓	δέ		_	
ὅτ̓	ὅτε	ADV	_	
ἀφ̓	ἀπό	PREP	_	
ὑψηλῆς	ὑψηλός	ADJ	number=SINGULAR|gender=FEMININE|case=GENITIVE	
κορυφῆς	κορυφή	NN	number=SINGULAR|gender=FEMININE|case=GENITIVE	
ὄρεος	ὄρος	NN	number=SINGULAR|gender=NEUTER|case=GENITIVE	
μεγάλοιο	μέγας	ADJ	number=SINGULAR|gender=NEUTER|case=GENITIVE	
πέτραι	πέτρα	NN	number=PLURAL|gender=FEMININE|case=NOMINATIVE	
ἀποθρῴσκωσιν	θρῴσκω	VB	person=PERSON_3|number=PLURAL|tense=PR|mood=SUBJUNCTIVE|voice=ACTIVE	
ἐπ̓	ἐπί	PREP	_	
ἀλλήλῃς	ἀλλήλων	ADJ	number=PLURAL|gender=FEMININE|case=DATIVE	
δὲ	δέ		_	
πέσωσι	πίπτω	VB	person=PERSON_3|number=PLURAL|mood=SUBJUNCTIVE|voice=ACTIVE	
πολλαὶ	πολύς	ADJ	number=PLURAL|gender=FEMININE|case=NOMINATIVE	
δὲ	δέ		_	
δρῦς	δρῦς	NN	number=PLURAL|gender=FEMININE|case=NOMINATIVE	
ὑψίκομοι	ὑψίκομος	ADJ	number=PLURAL|gender=FEMININE|case=NOMINATIVE	
πολλαὶ	πολύς	ADJ	number=PLURAL|gender=FEMININE|case=NOMINATIVE	
δὲ	δέ		_	
τε	τε		_	
πεῦκαι	πεύκη	NN	number=PLURAL|gender=FEMININE|case=NOMINATIVE	
αἴγειροί	αἴγειρος	NN	number=PLURAL|gender=FEMININE|case=NOMINATIVE	
τε	τε		_	
τανύρριζοι	τανύρριζος	ADJ	number=PLURAL|gender=FEMININE|case=NOMINATIVE	
ῥήγνυνται	ῥήγνυμι	VB	person=PERSON_3|number=PLURAL|tense=PR|mood=INDICATIVE	
ὑπ̓	ὑπό	PREP	_	
αὐτέων	αὐτός	ADJ	number=PLURAL|gender=FEMININE|case=GENITIVE	
ῥίμφα	ῥίμφα	ADV	_	
κυλινδομένων	κυλίνδω	VB	number=PLURAL|tense=PR|mood=PARTICIPLE|gender=FEMININE|case=GENITIVE	
εἵως	ἕως	CONJ	_	
πεδίονδ̓	πεδίονδε	ADV	_	
ἀφίκωνται	ἀφικνέομαι	VB	person=PERSON_3|number=PLURAL|mood=SUBJUNCTIVE	
ὣς	ὡς	ADV	_	
οἳ	ὁ	PRON	number=PLURAL|gender=MASCULINE|case=NOMINATIVE	
ἐπ̓	ἐπί	PREP	_	
ἀλλήλοισι	ἀλλήλων	ADJ	number=PLURAL|gender=MASCULINE|case=DATIVE	
πέσον	πίπτω	VB	person=PERSON_3|number=PLURAL|mood=INDICATIVE|voice=ACTIVE	
μέγα	μέγας	ADJ	number=SINGULAR|gender=NEUTER|case=ACCUSATIVE	
κεκλήγοντες	κλάζω	VB	number=PLURAL|tense=PERF|mood=PARTICIPLE|voice=ACTIVE|gender=MASCULINE|case=NOMINATIVE	
ἤδη	ἤδη	ADV	_	
γάρ	γάρ		_	
σφιν	σφεῖς	PRON	number=PLURAL|gender=MASCULINE|case=DATIVE	
ἔκειτο	κεῖμαι	VB	person=PERSON_3|number=SINGULAR|tense=IMP|mood=INDICATIVE	
μέγας	μέγας	ADJ	number=SINGULAR|gender=MASCULINE|case=NOMINATIVE	
λῖς	λίς	NN	number=SINGULAR|gender=MASCULINE|case=NOMINATIVE	
ἀμφὶ	ἀμφί	PREP	_	
δὲ	δέ		_	
κάπροι	κάπρος	NN	number=PLURAL|gender=MASCULINE|case=NOMINATIVE	
δοιοί	δοιοί	ADJ	number=PLURAL|gender=MASCULINE|case=NOMINATIVE	
ἀπουράμενοι	ἀπαυράω	VB	number=PLURAL|mood=PARTICIPLE|gender=MASCULINE|case=NOMINATIVE	
ψυχάς	ψυχή	NN	number=PLURAL|gender=FEMININE|case=ACCUSATIVE	
κατὰ	κατά	PREP	_	
δέ	δέ		_	
σφι	σφεῖς	PRON	number=PLURAL|gender=MASCULINE|case=DATIVE	
κελαινὸν	κελαινός	ADJ	number=SINGULAR|gender=NEUTER|case=NOMINATIVE	
αἷμ̓	αἷμα	NN	number=SINGULAR|gender=NEUTER|case=NOMINATIVE	
ἀπελείβετ̓	ἀπολείβω	VB	person=PERSON_3|number=SINGULAR|tense=IMP|mood=INDICATIVE	
ἔραζ̓	ἔραζε	ADV	_	
τῇσιν	ὁ	PRON	number=PLURAL|gender=FEMININE|case=DATIVE	
δὲ	δέ		_	
χοροὶ	χορός	NN	number=PLURAL|gender=MASCULINE|case=NOMINATIVE	
παίζοντες	παίζω	VB	number=PLURAL|tense=PR|mood=PARTICIPLE|voice=ACTIVE|gender=MASCULINE|case=NOMINATIVE	
ἕποντο	ἕπομαι	VB	person=PERSON_3|number=PLURAL|tense=IMP|mood=INDICATIVE	
ὣς	ὡς	ADV	_	
εἰπὼν	εἶπον	VB	number=SINGULAR|mood=PARTICIPLE|voice=ACTIVE|gender=MASCULINE|case=NOMINATIVE	
κνημῖδας	κνημίς	NN	number=PLURAL|gender=FEMININE|case=ACCUSATIVE	
ὀρειχάλκοιο	ὀρείχαλκος	NN	number=SINGULAR|gender=MASCULINE|case=GENITIVE	
φαεινοῦ	φαεινός	ADJ	number=SINGULAR|gender=MASCULINE|case=GENITIVE	
Ἡφαίστου	Ἥφαιστος	NN	number=SINGULAR|gender=MASCULINE|case=GENITIVE	
κλυτὰ	κλυτός	ADJ	number=PLURAL|gender=NEUTER|case=ACCUSATIVE	
δῶρα	δῶρον	NN	number=PLURAL|gender=NEUTER|case=ACCUSATIVE	
περὶ	περί	PREP	_	
κνήμῃσιν	κνήμη	NN	number=PLURAL|gender=FEMININE|case=DATIVE	
ἔθηκεν	τίθημι	VB	person=PERSON_3|number=SINGULAR|mood=INDICATIVE|voice=ACTIVE	
ὃ	ὁ	PRON	number=SINGULAR|gender=MASCULINE|case=NOMINATIVE	
δέ	δέ		_	
οἱ	ἕ	PRON	number=SINGULAR|gender=MASCULINE|case=DATIVE	
σχεδὸν	σχεδόν	PREP	_	
ἤλυθεν	ἔρχομαι	VB	person=PERSON_3|number=SINGULAR|mood=INDICATIVE|voice=ACTIVE	
ἀχνύμενος	ἀχεύω	VB	number=SINGULAR|tense=PR|mood=PARTICIPLE|voice=PASSIVE|gender=MASCULINE|case=NOMINATIVE	
κῆρ	κῆρ	NN	number=SINGULAR|gender=NEUTER|case=ACCUSATIVE	
οἳ	ὁ	PRON	number=PLURAL|gender=MASCULINE|case=NOMINATIVE	
δ̓	δέ		_	
ὑπὲρ	ὑπέρ	PREP	_	
αὐτέων	αὐτός	ADJ	number=PLURAL|gender=FEMININE|case=GENITIVE	
ἄνδρες	ἀνήρ	NN	number=PLURAL|gender=MASCULINE|case=NOMINATIVE	
ἐμαρνάσθην	μάρναμαι	VB	person=PERSON_3|tense=IMP|mood=INDICATIVE	
πολεμήια	πολεμήιος	ADJ	number=PLURAL|gender=NEUTER|case=ACCUSATIVE	
τεύχἐ	τεῦχος	NN	number=PLURAL|gender=NEUTER|case=ACCUSATIVE	
ἔχοντες	ἔχω	VB	number=PLURAL|tense=PR|mood=PARTICIPLE|voice=ACTIVE|gender=MASCULINE|case=NOMINATIVE	
τοὶ	ὁ	PRON	number=PLURAL|gender=MASCULINE|case=NOMINATIVE	
μὲν	μέν		_	
ὑπὲρ	ὑπέρ	PREP	_	
σφετέρης	σφέτερος	ADJ	number=SINGULAR|gender=FEMININE|case=GENITIVE	
πόλιος	πόλις	NN	number=SINGULAR|gender=FEMININE|case=GENITIVE	
σφετέρων	σφέτερος	ADJ	number=PLURAL|gender=MASCULINE|case=GENITIVE	
τε	τε		_	
τοκήων	τοκεύς	NN	number=PLURAL|gender=MASCULINE|case=GENITIVE	
λοιγὸν	λοιγός	NN	number=SINGULAR|gender=MASCULINE|case=ACCUSATIVE	
ἀμύνοντες	ἀμύνω	VB	number=PLURAL|tense=PR|mood=PARTICIPLE|voice=ACTIVE|gender=MASCULINE|case=NOMINATIVE	
τοὶ	ὁ	PRON	number=PLURAL|gender=MASCULINE|case=NOMINATIVE	
δὲ	δέ		_	
πραθέειν	πέρθω	VB	mood=INFINITIVE|voice=ACTIVE	
μεμαῶτες	μέμαα	VB	number=PLURAL|tense=PERF|mood=PARTICIPLE|voice=ACTIVE|gender=MASCULINE|case=NOMINATIVE	
ὡς	ὡς	ADV	_	
δὲ	δέ		_	
λέοντε	λέων	NN	gender=MASCULINE|case=NOMINATIVE	
δύω	δύο	NRL	_	
ἀμφὶ	ἀμφί	PREP	_	
κταμένης	κτείνω	VB	number=SINGULAR|mood=PARTICIPLE|gender=FEMININE|case=GENITIVE	
ἐλάφοιο	ἔλαφος	NN	number=SINGULAR|gender=FEMININE|case=GENITIVE	
ἀλλήλοις	ἀλλήλων	ADJ	number=PLURAL|gender=MASCULINE|case=DATIVE	
κοτέοντες	κοτέω	VB	number=PLURAL|tense=PR|mood=PARTICIPLE|voice=ACTIVE|gender=MASCULINE|case=NOMINATIVE	
ἐπὶ	ἐπί	PREP	_	
σφέας	σφεῖς	PRON	number=PLURAL|gender=MASCULINE|case=ACCUSATIVE	
ὁρμήσωσι	ὁρμάω	VB	person=PERSON_3|number=PLURAL|mood=SUBJUNCTIVE|voice=ACTIVE	
δεινὴ	δεινός	ADJ	number=SINGULAR|gender=FEMININE|case=NOMINATIVE	
δέ	δέ		_	
σφ̓	σφεῖς	PRON	number=PLURAL|gender=MASCULINE|case=DATIVE	
ἰαχὴ	ἰαχή	NN	number=SINGULAR|gender=FEMININE|case=NOMINATIVE	
ἄραβός	ἄραβος	NN	number=SINGULAR|gender=MASCULINE|case=NOMINATIVE	
θ̓	τε		_	
ἅμα	ἅμα	ADV	_	
γίγνετ̓	γίγνομαι	VB	person=PERSON_3|number=SINGULAR|tense=PR|mood=INDICATIVE	
ὀδόντων	ὀδούς	NN	number=PLURAL|gender=MASCULINE|case=GENITIVE	
ἦμος	ἦμος	ADV	_	
δὲ	δέ		_	
χλοερῷ	χλοερός	ADJ	number=SINGULAR|gender=MASCULINE|case=DATIVE	
κυανόπτερος	κυανόπτερος	ADJ	number=SINGULAR|gender=MASCULINE|case=NOMINATIVE	
ἠχέτα	ἠχέτης	NN	number=SINGULAR|gender=MASCULINE|case=NOMINATIVE	
τέττιξ	τέττιξ	NN	number=SINGULAR|gender=MASCULINE|case=NOMINATIVE	
ὄζῳ	ὄζος	NN	number=SINGULAR|gender=MASCULINE|case=DATIVE	
ἐφεζόμενος	ἐφέζομαι	VB	number=SINGULAR|tense=PR|mood=PARTICIPLE|gender=MASCULINE|case=NOMINATIVE	
θέρος	θέρος	NN	number=SINGULAR|gender=NEUTER|case=ACCUSATIVE	
ἀνθρώποισιν	ἄνθρωπος	NN	number=PLURAL|gender=MASCULINE|case=DATIVE	
ἀείδειν	ἀείδω	VB	tense=PR|mood=INFINITIVE|voice=ACTIVE	
ἄρχεται	ἄρχω	VB	person=PERSON_3|number=SINGULAR|tense=PR|mood=INDICATIVE	
ᾧ	ὅς	PRON	number=SINGULAR|gender=MASCULINE|case=DATIVE	
τε	τε		_	
πόσις	πόσις	NN	number=SINGULAR|gender=FEMININE|case=NOMINATIVE	
καὶ	καί	CONJ	_	
βρῶσις	βρῶσις	NN	number=SINGULAR|gender=FEMININE|case=NOMINATIVE	
θῆλυς	θῆλυς	ADJ	number=SINGULAR|gender=FEMININE|case=NOMINATIVE	
ἐέρση	ἔρσα	NN	number=SINGULAR|gender=FEMININE|case=NOMINATIVE	
καί	καί	CONJ	_	
τε	τε		_	
πανημέριός	πανημέριος	ADJ	number=SINGULAR|gender=MASCULINE|case=NOMINATIVE	
τε	τε		_	
καὶ	καί	CONJ	_	
ἠώιος	ἠῷος	ADJ	number=SINGULAR|gender=MASCULINE|case=NOMINATIVE	
χέει	χέω	VB	person=PERSON_3|number=SINGULAR|tense=PR|mood=INDICATIVE|voice=ACTIVE	
αὐδὴν	αὐδή	NN	number=SINGULAR|gender=FEMININE|case=ACCUSATIVE	
ἴδει	ἶδος	NN	number=SINGULAR|gender=NEUTER|case=DATIVE	
ἐν	ἐν	PREP	_	
αἰνοτάτῳ	αἰνός	ADJ	number=SINGULAR|gender=NEUTER|case=DATIVE|degree=SUPERLATIVE	
ὅτε	ὅτε	ADV	_	
τε	τε		_	
χρόα	χρώς	NN	number=SINGULAR|gender=MASCULINE|case=ACCUSATIVE	
Σείριος	σείριος	NN	number=SINGULAR|gender=MASCULINE|case=NOMINATIVE	
ἄζει	ἄζω	VB	person=PERSON_3|number=SINGULAR|tense=PR|mood=INDICATIVE|voice=ACTIVE	
τῆμος	τῆμος	ADV	_	
δὴ	δή		_	
κέγχροισι	κέγχρος	NN	number=PLURAL|gender=MASCULINE|case=DATIVE	
πέρι	περί	PREP	_	
γλῶχες	γλώξ	NN	number=PLURAL|gender=FEMININE|case=NOMINATIVE	
τελέθουσι	τελέθω	VB	person=PERSON_3|number=PLURAL|tense=PR|mood=INDICATIVE|voice=ACTIVE	
τούς	ὁ	PRON	number=PLURAL|gender=MASCULINE|case=ACCUSATIVE	
τε	τε		_	
θέρει	θέρος	NN	number=SINGULAR|gender=NEUTER|case=DATIVE	
σπείρουσιν	σπείρω	VB	person=PERSON_3|number=PLURAL|tense=PR|mood=INDICATIVE|voice=ACTIVE	
ὅτ̓	ὅτε	ADV	_	
ὄμφακες	ὄμφαξ	NN	number=PLURAL|gender=FEMININE|case=NOMINATIVE	
αἰόλλονται	αἰόλλω	VB	person=PERSON_3|number=PLURAL|tense=PR|mood=INDICATIVE	
οἷα	οἷος	ADJ	number=PLURAL|gender=NEUTER|case=ACCUSATIVE	
Διώνυσος	Διόνυσος	NN	number=SINGULAR|gender=MASCULINE|case=NOMINATIVE	
δῶκ̓	δίδωμι	VB	person=PERSON_3|number=SINGULAR|mood=INDICATIVE|voice=ACTIVE	
ἀνδράσι	ἀνήρ	NN	number=PLURAL|gender=MASCULINE|case=DATIVE	
χάρμα	χάρμα	NN	number=SINGULAR|gender=NEUTER|case=ACCUSATIVE	
καὶ	καί	CONJ	_	
ἄχθος	ἄχθος	NN	number=SINGULAR|gender=NEUTER|case=ACCUSATIVE	
τὸν	ὁ	PRON	number=SINGULAR|gender=MASCULINE|case=ACCUSATIVE	
μὲν	μέν		_	
βροτῷ	βροτός	NN	number=SINGULAR|gender=MASCULINE|case=DATIVE	
ἀνδρὶ	ἀνήρ	NN	number=SINGULAR|gender=MASCULINE|case=DATIVE	
μιγεῖσα	μίγνυμι	VB	number=SINGULAR|mood=PARTICIPLE|voice=PASSIVE|gender=FEMININE|case=NOMINATIVE	
τὸν	ὁ	PRON	number=SINGULAR|gender=MASCULINE|case=ACCUSATIVE	
δὲ	δέ		_	
Διὶ	Ζεύς	NN	number=SINGULAR|gender=MASCULINE|case=DATIVE	
Κρονίωνι	Κρονίων	NN	number=SINGULAR|gender=MASCULINE|case=DATIVE	
θεῶν	θεός	NN	number=PLURAL|gender=MASCULINE|case=GENITIVE	
σημάντορι	σημάντωρ	NN	number=SINGULAR|gender=MASCULINE|case=DATIVE	
πάντων	πᾶς	ADJ	number=PLURAL|gender=MASCULINE|case=GENITIVE	
κυάνεοι	κυάνεος	ADJ	number=PLURAL|gender=MASCULINE|case=NOMINATIVE	
κατὰ	κατά	PREP	_	
νῶτα	νῶτον	NN	number=PLURAL|gender=NEUTER|case=ACCUSATIVE	
μελάνθησαν	μελαίνω	VB	person=PERSON_3|number=PLURAL|mood=INDICATIVE|voice=PASSIVE	
δὲ	δέ		_	
γένεια	γένειον	NN	number=PLURAL|gender=NEUTER|case=NOMINATIVE	
ἵκετο	ἱκνέομαι	VB	person=PERSON_3|number=SINGULAR|mood=INDICATIVE	
δ̓	δέ		_	
ἐς	εἰς	PREP	_	
Κρείοντα	Κρείων	NN	number=SINGULAR|gender=MASCULINE|case=ACCUSATIVE	
καὶ	καί	CONJ	_	
Ἠνιόχην	Ἠνιόχη	NN	number=SINGULAR|gender=FEMININE|case=ACCUSATIVE	
τανύπεπλον	τανύπεπλος	ADJ	number=SINGULAR|gender=FEMININE|case=ACCUSATIVE	
οἵ	ὅς	PRON	number=PLURAL|gender=MASCULINE|case=NOMINATIVE	
ῥά	ἄρα		_	
μιν	μιν	PRON	number=SINGULAR|gender=MASCULINE|case=ACCUSATIVE	
ἠσπάζοντο	ἀσπάζομαι	VB	person=PERSON_3|number=PLURAL|tense=IMP|mood=INDICATIVE	
καὶ	καί	CONJ	_	
ἄρμενα	ἄρμενα	NN	number=PLURAL|gender=NEUTER|case=ACCUSATIVE	
πάντα	πᾶς	ADJ	number=PLURAL|gender=NEUTER|case=ACCUSATIVE	
παρεῖχον	παρέχω	VB	person=PERSON_3|number=PLURAL|tense=IMP|mood=INDICATIVE|voice=ACTIVE	
ἣ	ὅς	PRON	number=SINGULAR|gender=FEMININE|case=NOMINATIVE	
δίκη	δίκη	NN	number=SINGULAR|gender=FEMININE|case=NOMINATIVE	
ἔσθ̓	εἰμί	VB	person=PERSON_3|number=SINGULAR|tense=PR|mood=INDICATIVE|voice=ACTIVE	
ἱκέτῃσι	ἱκέτης	NN	number=PLURAL|gender=MASCULINE|case=DATIVE	
τίον	τίω	VB	person=PERSON_3|number=PLURAL|tense=IMP|mood=INDICATIVE|voice=ACTIVE	
δέ	δέ		_	
ἑ	ἕ	PRON	number=SINGULAR|gender=MASCULINE|case=ACCUSATIVE	
κηρόθι	κηρόθι	ADV	_	
μᾶλλον	μᾶλλον	ADV	_	
ἀλλὰ	ἀλλά	CONJ	_	
παρὲξ	παρέξ	ADV	_	
ἔχε	ἔχω	VB	person=PERSON_2|number=SINGULAR|tense=PR|mood=IMPERATIVE|voice=ACTIVE	
δίφρον	δίφρος	NN	number=SINGULAR|gender=MASCULINE|case=ACCUSATIVE	
ἐύξοον	εὔξοος	ADJ	number=SINGULAR|gender=MASCULINE|case=ACCUSATIVE	
ἠδὲ	ἠδέ	CONJ	_	
κελεύθου	κέλευθος	NN	number=SINGULAR|gender=FEMININE|case=GENITIVE	
εἶκε	εἴκω	VB	person=PERSON_2|number=SINGULAR|tense=PR|mood=IMPERATIVE|voice=ACTIVE	
παρὲξ	παρέξ	ADV	_	
ἰέναι	εἶμι	VB	tense=PR|mood=INFINITIVE|voice=ACTIVE	
πᾶσαν	πᾶς	ADJ	number=SINGULAR|gender=FEMININE|case=ACCUSATIVE	
δὲ	δέ		_	
πόλιν	πόλις	NN	number=SINGULAR|gender=FEMININE|case=ACCUSATIVE	
θαλίαι	θαλία	NN	number=PLURAL|gender=FEMININE|case=NOMINATIVE	
τε	τε		_	
χοροί	χορός	NN	number=PLURAL|gender=MASCULINE|case=NOMINATIVE	
τε	τε		_	
ἀγλαΐαι	ἀγλαία	NN	number=PLURAL|gender=FEMININE|case=NOMINATIVE	
τ̓	τε		_	
εἶχον	ἔχω	VB	person=PERSON_3|number=PLURAL|tense=IMP|mood=INDICATIVE|voice=ACTIVE	
Τρηχῖνα	Τραχίς	NN	number=SINGULAR|gender=FEMININE|case=ACCUSATIVE	
δέ	δέ		_	
τοι	τοι		_	
παρελαύνω	παρελαύνω	VB	person=PERSON_1|number=SINGULAR|tense=PR|mood=INDICATIVE|voice=ACTIVE	
ἐς	εἰς	PREP	_	
Κήυκα	Κῆυξ	NN	number=SINGULAR|gender=MASCULINE|case=ACCUSATIVE	
ἄνακτα	ἄναξ	NN	number=SINGULAR|gender=MASCULINE|case=ACCUSATIVE	
ἔνθα	ἔνθα	ADV	_	
καθεζόμενος	καθέζομαι	VB	number=PLURAL|tense=PR|mood=PARTICIPLE|gender=MASCULINE|case=NOMINATIVE	
φρεσὶ	φρήν	NN	number=PLURAL|gender=FEMININE|case=DATIVE	
μήδετο	μήδομαι	VB	person=PERSON_3|number=SINGULAR|tense=IMP|mood=INDICATIVE	
θέσκελα	θέσκελος	ADJ	number=PLURAL|gender=NEUTER|case=ACCUSATIVE	
ἔργα	ἔργον	NN	number=PLURAL|gender=NEUTER|case=ACCUSATIVE	
καί	καί	CONJ	_	
ῥ̓	ἄρα		_	
ἔμβαλε	ἐμβάλλω	VB	person=PERSON_3|number=SINGULAR|mood=INDICATIVE|voice=ACTIVE	
χάλκεον	χάλκεος	ADJ	number=SINGULAR|gender=NEUTER|case=ACCUSATIVE	
ἔγχος	ἔγχος	NN	number=SINGULAR|gender=NEUTER|case=ACCUSATIVE	
σπερχνὸν	σπερχνός	ADJ	number=SINGULAR|gender=NEUTER|case=ACCUSATIVE	
παιδὸς	παῖς	NN	number=SINGULAR|gender=MASCULINE|case=GENITIVE	
ἑοῦ	ἑός	ADJ	number=SINGULAR|gender=MASCULINE|case=GENITIVE	
κοτέων	κοτέω	VB	number=SINGULAR|tense=PR|mood=PARTICIPLE|voice=ACTIVE|gender=MASCULINE|case=NOMINATIVE	
πέρι	περί	PREP	_	
τεθνηῶτος	θνήσκω	VB	number=SINGULAR|tense=PERF|mood=PARTICIPLE|voice=ACTIVE|gender=MASCULINE|case=GENITIVE	
ἐν	ἐν	PREP	_	
σάκεϊ	σάκος	NN	number=SINGULAR|gender=NEUTER|case=DATIVE	
μεγάλῳ	μέγας	ADJ	number=SINGULAR|gender=NEUTER|case=DATIVE	
τῷ	ὁ	PRON	number=SINGULAR|gender=MASCULINE|case=DATIVE	
ἴκελος	ἴκελος	ADJ	number=SINGULAR|gender=MASCULINE|case=NOMINATIVE	
Διὸς	Ζεύς	NN	number=SINGULAR|gender=MASCULINE|case=GENITIVE	
υἱὸς	υἱός	NN	number=SINGULAR|gender=MASCULINE|case=NOMINATIVE	
ἀφ̓	ἀπό	PREP	_	
ἱππείου	ἵππειος	ADJ	number=SINGULAR|gender=MASCULINE|case=GENITIVE	
θόρε	θρῴσκω	VB	person=PERSON_3|number=SINGULAR|mood=INDICATIVE|voice=ACTIVE	
δίφρου	δίφρος	NN	number=SINGULAR|gender=MASCULINE|case=GENITIVE	
[θεῶν	θεός	NN	number=PLURAL|gender=MASCULINE|case=GENITIVE	
δ̓	δέ		_	
ἕδος	ἕδος	NN	number=SINGULAR|gender=NEUTER|case=NOMINATIVE	
ἁγνὸς	ἁγνός	ADJ	number=SINGULAR|gender=MASCULINE|case=NOMINATIVE	
Ὄλυμπος	Ὄλυμπος	NN	number=SINGULAR|gender=MASCULINE|case=NOMINATIVE	
πὰρ	παρά	PREP	_	
δ̓	δέ		_	
αὐτοῖς	αὐτός	ADJ	number=PLURAL|gender=MASCULINE|case=DATIVE	
ἱππῆες	ἱππεύς	NN	number=PLURAL|gender=MASCULINE|case=NOMINATIVE	
ἔχον	ἔχω	VB	person=PERSON_3|number=PLURAL|tense=IMP|mood=INDICATIVE|voice=ACTIVE	
πόνον	πόνος	NN	number=SINGULAR|gender=MASCULINE|case=ACCUSATIVE	
ἀμφὶ	ἀμφί	PREP	_	
δ̓	δέ		_	
ἀέθλῳ	ἆθλον	NN	number=SINGULAR|gender=NEUTER|case=DATIVE	
δῆριν	δῆρις	NN	number=SINGULAR|gender=FEMININE|case=ACCUSATIVE	
ἔχον	ἔχω	VB	person=PERSON_3|number=PLURAL|tense=IMP|mood=INDICATIVE|voice=ACTIVE	
καὶ	καί	CONJ	_	
μόχθον	μόχθος	NN	number=SINGULAR|gender=MASCULINE|case=ACCUSATIVE	
περιστονάχησε	περιστοναχέω	VB	person=PERSON_3|number=SINGULAR|mood=INDICATIVE|voice=ACTIVE	
δὲ	δέ		_	
γαῖα	γαῖα	NN	number=SINGULAR|gender=FEMININE|case=NOMINATIVE	
οἳ	ὁ	PRON	number=PLURAL|gender=MASCULINE|case=NOMINATIVE	
δ̓	δέ		_	
αὖτ̓	αὖτε	ADV	_	
ἐς	εἰς	PREP	_	
ταλάρους	τάλαρος	NN	number=PLURAL|gender=MASCULINE|case=ACCUSATIVE	
ἐφόρευν	φορέω	VB	person=PERSON_3|number=PLURAL|tense=IMP|mood=INDICATIVE|voice=ACTIVE	
μελάνθησάν	μελαίνω	VB	person=PERSON_3|number=PLURAL|mood=INDICATIVE|voice=PASSIVE	
γε	γε		_	
μὲν	μέν		_	
αἵδε	ὅδε	PRON	number=PLURAL|gender=FEMININE|case=NOMINATIVE	
ἀπὸ	ἀπό	PREP	_	
δ̓	δέ		_	
ἄμφω	ἄμφω	ADJ	gender=MASCULINE|case=ACCUSATIVE	
κέρσε	κείρω	VB	person=PERSON_3|number=SINGULAR|mood=INDICATIVE|voice=ACTIVE	
τένοντε	τένων	NN	gender=MASCULINE|case=ACCUSATIVE	
ἀνδροφόνος	ἀνδροφόνος	ADJ	number=SINGULAR|gender=FEMININE|case=NOMINATIVE	
μελίη	μελία	NN	number=SINGULAR|gender=FEMININE|case=NOMINATIVE	
τὴν	ὁ	PRON	number=SINGULAR|gender=FEMININE|case=ACCUSATIVE	
ὥρην	ὥρα	NN	number=SINGULAR|gender=FEMININE|case=ACCUSATIVE	
μάρναντο	μάρναμαι	VB	person=PERSON_3|number=PLURAL|tense=IMP|mood=INDICATIVE	
πολὺς	πολύς	ADJ	number=SINGULAR|gender=MASCULINE|case=NOMINATIVE	
δ̓	δέ		_	
ὀρυμαγδὸς	ὀρυμαγδός	NN	number=SINGULAR|gender=MASCULINE|case=NOMINATIVE	
ὀρώρει	ὄρνυμι	VB	person=PERSON_3|number=SINGULAR|tense=PLUSQUAMPERFECT|mood=INDICATIVE|voice=ACTIVE	
θεαὶ	θεά	NN	number=PLURAL|gender=FEMININE|case=NOMINATIVE	
δ̓	δέ		_	
ἐξῆρχον	ἐξάρχω	VB	person=PERSON_3|number=PLURAL|tense=IMP|mood=INDICATIVE|voice=ACTIVE	
ἀοιδῆς	ἀοιδή	NN	number=SINGULAR|gender=FEMININE|case=GENITIVE	
Μοῦσαι	Μοῦσα	NN	number=PLURAL|gender=FEMININE|case=NOMINATIVE	
Πιερίδες	Πιερίδες	NN	number=PLURAL|gender=FEMININE|case=NOMINATIVE	
λιγὺ	λιγύς	ADJ	number=SINGULAR|gender=NEUTER|case=ACCUSATIVE	
μελπομένῃς	μέλπω	VB	number=PLURAL|tense=PR|mood=PARTICIPLE|gender=FEMININE|case=DATIVE	
ἐικυῖαι	εἰκός	VB	number=PLURAL|tense=PERF|mood=PARTICIPLE|voice=ACTIVE|gender=FEMININE|case=NOMINATIVE	
ἐν	ἐν	PREP	_	
δὲ	δέ		_	
Προΐωξίς	προίωξις	NN	number=SINGULAR|gender=FEMININE|case=NOMINATIVE	
τε	τε		_	
Παλίωξίς	παλίωξις	NN	number=SINGULAR|gender=FEMININE|case=NOMINATIVE	
τε	τε		_	
τέτυκτο	τεύχω	VB	person=PERSON_3|number=SINGULAR|tense=PLUSQUAMPERFECT|mood=INDICATIVE	
ἐν	ἐν	PREP	_	
δ̓	δέ		_	
Ὅμαδός	ὅμαδος	NN	number=SINGULAR|gender=MASCULINE|case=NOMINATIVE	
τε	τε		_	
Φόβος	φόβος	NN	number=SINGULAR|gender=MASCULINE|case=NOMINATIVE	
τ̓	τε		_	
Ἀνδροκτασίη	ἀνδροκτασία	NN	number=SINGULAR|gender=FEMININE|case=NOMINATIVE	
τε	τε		_	
δεδήει	δαίω	VB	person=PERSON_3|number=SINGULAR|tense=PLUSQUAMPERFECT|mood=INDICATIVE|voice=ACTIVE	
ἐν	ἐν	PREP	_	
δ̓	δέ		_	
Ἔρις	ἔρις	NN	number=SINGULAR|gender=FEMININE|case=NOMINATIVE	
ἐν	ἐν	PREP	_	
δὲ	δέ		_	
Κυδοιμὸς	κυδοιμός	NN	number=SINGULAR|gender=MASCULINE|case=NOMINATIVE	
ἐθύνεον	θυνέω	VB	person=PERSON_3|number=PLURAL|tense=IMP|mood=INDICATIVE|voice=ACTIVE	
ἐν	ἐν	PREP	_	
δ̓	δέ		_	
ὀλοὴ	ὀλοός	ADJ	number=SINGULAR|gender=FEMININE|case=NOMINATIVE	
Κὴρ	Κήρ	NN	number=SINGULAR|gender=FEMININE|case=NOMINATIVE	
ἄλλον	ἄλλος	ADJ	number=SINGULAR|gender=MASCULINE|case=ACCUSATIVE	
ζωὸν	ζωός	ADJ	number=SINGULAR|gender=MASCULINE|case=ACCUSATIVE	
ἔχουσα	ἔχω	VB	number=SINGULAR|tense=PR|mood=PARTICIPLE|voice=ACTIVE|gender=FEMININE|case=NOMINATIVE	
νεούτατον	νεούτατος	ADJ	number=SINGULAR|gender=MASCULINE|case=ACCUSATIVE	
ἄλλον	ἄλλος	ADJ	number=SINGULAR|gender=MASCULINE|case=ACCUSATIVE	
ἄουτον	ἄουτος	ADJ	number=SINGULAR|gender=MASCULINE|case=ACCUSATIVE	
ἄλλον	ἄλλος	ADJ	number=SINGULAR|gender=MASCULINE|case=ACCUSATIVE	
τεθνηῶτα	θνήσκω	VB	number=SINGULAR|tense=PERF|mood=PARTICIPLE|voice=ACTIVE|gender=MASCULINE|case=ACCUSATIVE	
κατὰ	κατά	PREP	_	
μόθον	μόθος	NN	number=SINGULAR|gender=MASCULINE|case=ACCUSATIVE	
ἕλκε	ἕλκω	VB	person=PERSON_3|number=SINGULAR|tense=IMP|mood=INDICATIVE|voice=ACTIVE	
ποδοῖιν	πούς	NN	gender=MASCULINE|case=GENITIVE	
ὃ	ὁ	PRON	number=SINGULAR|gender=MASCULINE|case=NOMINATIVE	
δ̓	δέ		_	
ὥς	ὡς	CONJ	_	
τε	τε		_	
νόημ̓	νόημα	NN	number=SINGULAR|gender=NEUTER|case=NOMINATIVE	
ἐποτᾶτο	ποτάομαι	VB	person=PERSON_3|number=SINGULAR|tense=IMP|mood=INDICATIVE	
τῆλε	τῆλε	ADV	_	
δ̓	δέ		_	
ἀπ̓	ἀπό	PREP	_	
αἰθομένων	αἴθω	VB	number=PLURAL|tense=PR|mood=PARTICIPLE|gender=FEMININE|case=GENITIVE	
δαΐδων	δαίς	NN	number=PLURAL|gender=FEMININE|case=GENITIVE	
σέλας	σέλας	NN	number=SINGULAR|gender=NEUTER|case=NOMINATIVE	
εἰλύφαζε	εἰλυφάζω	VB	person=PERSON_3|number=SINGULAR|tense=IMP|mood=INDICATIVE|voice=ACTIVE	
χερσὶν	χείρ	NN	number=PLURAL|gender=FEMININE|case=DATIVE	
ἔνι	ἐν	PREP	_	
δμῳῶν	δμωή	NN	number=PLURAL|gender=FEMININE|case=GENITIVE	
παννύχιος	παννύχιος	ADJ	number=SINGULAR|gender=MASCULINE|case=NOMINATIVE	
δ̓	δέ		_	
ἄῤ	ἄρα		_	
ἔλεκτο	λέγω	VB	person=PERSON_3|number=SINGULAR|mood=INDICATIVE|voice=PASSIVE	
σὺν	σύν	PREP	_	
αἰδοίῃ	αἰδοῖος	ADJ	number=SINGULAR|gender=FEMININE|case=DATIVE	
παρακοίτι	παράκοιτις	NN	number=SINGULAR|gender=FEMININE|case=DATIVE	
τερπόμενος	τέρπω	VB	number=SINGULAR|tense=PR|mood=PARTICIPLE|gender=MASCULINE|case=NOMINATIVE	
δώροισι	δῶρον	NN	number=PLURAL|gender=NEUTER|case=DATIVE	
πολυχρύσου	πολύχρυσος	ADJ	number=SINGULAR|gender=FEMININE|case=GENITIVE	
Ἀφροδίτης	Ἀφροδίτη	NN	number=SINGULAR|gender=FEMININE|case=GENITIVE	
τοὶ	ὁ	PRON	number=PLURAL|gender=MASCULINE|case=NOMINATIVE	
δ̓	δέ		_	
αὖ	αὖ	ADV	_	
προπάροιθε	προπάροιθε	PREP	_	
πόληος	πόλις	NN	number=SINGULAR|gender=FEMININE|case=GENITIVE	
νῶθ̓	νῶτον	NN	number=PLURAL|gender=NEUTER|case=ACCUSATIVE	
ἵππων	ἵππος	NN	number=PLURAL|gender=MASCULINE|case=GENITIVE	
ἐπιβάντες	ἐπιβαίνω	VB	number=PLURAL|mood=PARTICIPLE|voice=ACTIVE|gender=MASCULINE|case=NOMINATIVE	
ἐθύνεον	θυνέω	VB	person=PERSON_3|number=PLURAL|tense=IMP|mood=INDICATIVE|voice=ACTIVE	
θαῦμα	θαῦμα	NN	number=SINGULAR|gender=NEUTER|case=NOMINATIVE	
ἰδεῖν	εἶδον	VB	mood=INFINITIVE|voice=ACTIVE	
καὶ	καί	ADV	_	
Ζηνὶ	Ζεύς	NN	number=SINGULAR|gender=MASCULINE|case=DATIVE	
βαρυκτύπῳ	βαρύκτυπος	ADJ	number=SINGULAR|gender=MASCULINE|case=DATIVE	
οὗ	ὅς	PRON	number=SINGULAR|gender=MASCULINE|case=GENITIVE	
διὰ	διά	PREP	_	
βουλὰς	βουλή	NN	number=PLURAL|gender=FEMININE|case=ACCUSATIVE	
Ἥφαιστος	Ἥφαιστος	NN	number=SINGULAR|gender=MASCULINE|case=NOMINATIVE	
ποίησε	ποιέω	VB	person=PERSON_3|number=SINGULAR|mood=INDICATIVE|voice=ACTIVE	
σάκος	σάκος	NN	number=SINGULAR|gender=NEUTER|case=ACCUSATIVE	
μέγα	μέγας	ADJ	number=SINGULAR|gender=NEUTER|case=ACCUSATIVE	
τε	τε		_	
στιβαρόν	στιβαρός	ADJ	number=SINGULAR|gender=NEUTER|case=ACCUSATIVE	
τε	τε		_	
ἀρσάμενος	ἀραρίσκω	VB	number=SINGULAR|mood=PARTICIPLE|gender=MASCULINE|case=NOMINATIVE	
παλάμῃσι	παλάμη	NN	number=PLURAL|gender=FEMININE|case=DATIVE	
ἢ	ἤ	CONJ	_	
οἵη	οἷος	ADJ	number=SINGULAR|gender=FEMININE|case=NOMINATIVE	
προλιποῦσα	προλείπω	VB	number=SINGULAR|mood=PARTICIPLE|voice=ACTIVE|gender=FEMININE|case=NOMINATIVE	
δόμους	δόμος	NN	number=PLURAL|gender=MASCULINE|case=ACCUSATIVE	
καὶ	καί	CONJ	_	
πατρίδα	πατρίς	ADJ	number=SINGULAR|gender=FEMININE|case=ACCUSATIVE	
γαῖαν	γαῖα	NN	number=SINGULAR|gender=FEMININE|case=ACCUSATIVE	
ἤλυθεν	ἔρχομαι	VB	person=PERSON_3|number=SINGULAR|mood=INDICATIVE|voice=ACTIVE	
ἐς	εἰς	PREP	_	
Θήβας	Θῆβαι	NN	number=PLURAL|gender=FEMININE|case=ACCUSATIVE	
μετ̓	μετά	PREP	_	
ἀρήιον	ἄρειος	ADJ	number=SINGULAR|gender=MASCULINE|case=ACCUSATIVE	
Ἀμφιτρύωνα	Ἀμφιτρύων	NN	number=SINGULAR|gender=MASCULINE|case=ACCUSATIVE	
Ἀλκμήνη	Ἀλκμήνη	NN	number=SINGULAR|gender=FEMININE|case=NOMINATIVE	
θυγάτηρ	θυγάτηρ	NN	number=SINGULAR|gender=FEMININE|case=NOMINATIVE	
λαοσσόου	λαοσσόος	ADJ	number=SINGULAR|gender=MASCULINE|case=GENITIVE	
Ἠλεκτρύωνος	Ἠλεκτρύον	NN	number=SINGULAR|gender=MASCULINE|case=GENITIVE	
αὐτὰρ	ἀτάρ	CONJ	_	
ἔην	εἰμί	VB	person=PERSON_3|number=SINGULAR|tense=IMP|mood=INDICATIVE|voice=ACTIVE	
βαθὺ	βαθύς	ADJ	number=SINGULAR|gender=NEUTER|case=NOMINATIVE	
λήιον	λήιον	NN	number=SINGULAR|gender=NEUTER|case=NOMINATIVE	
ἣ	ὁ	PRON	number=SINGULAR|gender=FEMININE|case=NOMINATIVE	
δὲ	δέ		_	
καὶ	καί	ADV	_	
ὣς	ὡς	ADV	_	
κατὰ	κατά	PREP	_	
θυμὸν	θυμός	NN	number=SINGULAR|gender=MASCULINE|case=ACCUSATIVE	
ἑὸν	ἑός	ADJ	number=SINGULAR|gender=MASCULINE|case=ACCUSATIVE	
τίεσκεν	τίω	VB	person=PERSON_3|number=SINGULAR|tense=IMP|mood=INDICATIVE|voice=ACTIVE	
ἀκοίτην	ἀκοίτης	NN	number=SINGULAR|gender=MASCULINE|case=ACCUSATIVE	
ὡς	ὡς	CONJ	_	
οὔ	οὐ	ADV	_	
πώ	πω		_	
τις	τις	PRON	number=SINGULAR|gender=FEMININE|case=NOMINATIVE	
ἔτισε	τίνω	VB	person=PERSON_3|number=SINGULAR|mood=INDICATIVE|voice=ACTIVE	
γυναικῶν	γυνή	NN	number=PLURAL|gender=FEMININE|case=GENITIVE	
θηλυτεράων	θῆλυς	ADJ	number=PLURAL|gender=FEMININE|case=GENITIVE	
λίχμαζον	λιχμάζω	VB	person=PERSON_3|number=PLURAL|tense=IMP|mood=INDICATIVE|voice=ACTIVE	
δ̓	δέ		_	
ἄρα	ἄρα		_	
τώ	ὁ	PRON	gender=MASCULINE|case=NOMINATIVE	
γε	γε		_	
τῷ	ὁ	PRON	number=SINGULAR|gender=MASCULINE|case=DATIVE	
δὲ	δέ		_	
Φόβος	φόβος	NN	number=SINGULAR|gender=MASCULINE|case=NOMINATIVE	
καὶ	καί	CONJ	_	
Δεῖμος	Δεῖμος	NN	number=SINGULAR|gender=MASCULINE|case=NOMINATIVE	
ἐύτροχον	εὔτροχος	ADJ	number=SINGULAR|gender=NEUTER|case=ACCUSATIVE	
ἅρμα	ἅρμα	NN	number=SINGULAR|gender=NEUTER|case=ACCUSATIVE	
καὶ	καί	CONJ	_	
ἵππους	ἵππος	NN	number=PLURAL|gender=MASCULINE|case=ACCUSATIVE	
ἤλασαν	ἐλαύνω	VB	person=PERSON_3|number=PLURAL|mood=INDICATIVE|voice=ACTIVE	
αἶψ̓	αἶψα	ADV	_	
ἐγγύς	ἐγγύς	ADV	_	
καὶ	καί	CONJ	_	
ἀπὸ	ἀπό	PREP	_	
χθονὸς	χθών	NN	number=SINGULAR|gender=FEMININE|case=GENITIVE	
εὐρυοδείης	εὐρυόδεια	NN	number=SINGULAR|gender=FEMININE|case=GENITIVE	
ἐς	εἰς	PREP	_	
δίφρον	δίφρος	NN	number=SINGULAR|gender=MASCULINE|case=ACCUSATIVE	
θῆκαν	τίθημι	VB	person=PERSON_3|number=PLURAL|mood=INDICATIVE|voice=ACTIVE	
πολυδαίδαλον	πολυδαίδαλος	ADJ	number=SINGULAR|gender=MASCULINE|case=ACCUSATIVE	
τάχα	τάχα	ADV	_	
δ̓	δέ		_	
ἷξε	ἵκω	VB	person=PERSON_3|number=SINGULAR|mood=INDICATIVE|voice=ACTIVE	
Τυφαόνιον	Τυφαόνιον	NN	number=SINGULAR|gender=MASCULINE|case=ACCUSATIVE	
θήκατο	τίθημι	VB	person=PERSON_3|number=SINGULAR|mood=INDICATIVE	
δ̓	δέ		_	
ἀμφ̓	ἀμφί	PREP	_	
ὤμοισιν	ὦμος	NN	number=PLURAL|gender=MASCULINE|case=DATIVE	
ἀρῆς	ἀρή	NN	number=SINGULAR|gender=FEMININE|case=GENITIVE	
ἀλκτῆρα	ἀλκτήρ	NN	number=SINGULAR|gender=MASCULINE|case=ACCUSATIVE	
σίδηρον	σίδηρος	NN	number=SINGULAR|gender=MASCULINE|case=ACCUSATIVE	
δεινὸς	δεινός	ADJ	number=SINGULAR|gender=MASCULINE|case=NOMINATIVE	
ἀνήρ	ἀνήρ	NN	number=SINGULAR|gender=MASCULINE|case=NOMINATIVE	
ἐν	ἐν	PREP	_	
δ̓	δέ		_	
Ἄρεος	Ἄρης	NN	number=SINGULAR|gender=MASCULINE|case=GENITIVE	
βλοσυροῖο	βλοσυρός	ADJ	number=SINGULAR|gender=MASCULINE|case=GENITIVE	
ποδώκεες	ποδώκης	ADJ	number=PLURAL|gender=MASCULINE|case=NOMINATIVE	
ἕστασαν	ἵστημι	VB	person=PERSON_3|number=PLURAL|tense=PLUSQUAMPERFECT|mood=INDICATIVE|voice=ACTIVE	
ἵπποι	ἵππος	NN	number=PLURAL|gender=MASCULINE|case=NOMINATIVE	
χρύσεοι	χρύσεος	ADJ	number=PLURAL|gender=MASCULINE|case=NOMINATIVE	
ἐν	ἐν	PREP	_	
δὲ	δέ		_	
καὶ	καί	ADV	_	
αὐτὸς	αὐτός	ADJ	number=SINGULAR|gender=MASCULINE|case=NOMINATIVE	
ἐναρσφόρος	ἐναρηφόρος	ADJ	number=SINGULAR|gender=MASCULINE|case=NOMINATIVE	
οὔλιος	οὔλιος	ADJ	number=SINGULAR|gender=MASCULINE|case=NOMINATIVE	
Ἄρης	Ἄρης	NN	number=SINGULAR|gender=MASCULINE|case=NOMINATIVE	
αἰχμὴν	αἰχμή	NN	number=SINGULAR|gender=FEMININE|case=ACCUSATIVE	
ἐν	ἐν	PREP	_	
χείρεσσιν	χείρ	NN	number=PLURAL|gender=FEMININE|case=DATIVE	
ἔχων	ἔχω	VB	number=SINGULAR|tense=PR|mood=PARTICIPLE|voice=ACTIVE|gender=MASCULINE|case=NOMINATIVE	
πρυλέεσσι	πρυλέες	NN	number=PLURAL|gender=MASCULINE|case=DATIVE	
κελεύων	κελεύω	VB	number=SINGULAR|tense=PR|mood=PARTICIPLE|voice=ACTIVE|gender=MASCULINE|case=NOMINATIVE	
αἵματι	αἷμα	NN	number=SINGULAR|gender=NEUTER|case=DATIVE	
φοινικόεις	φοινικόεις	ADJ	number=SINGULAR|gender=MASCULINE|case=NOMINATIVE	
ὡς	ὡς	ADV	_	
εἰ	εἰ	CONJ	_	
ζωοὺς	ζωός	ADJ	number=PLURAL|gender=MASCULINE|case=ACCUSATIVE	
ἐναρίζων	ἐναρίζω	VB	number=SINGULAR|tense=PR|mood=PARTICIPLE|voice=ACTIVE|gender=MASCULINE|case=NOMINATIVE	
δίφρου	δίφρος	NN	number=SINGULAR|gender=MASCULINE|case=GENITIVE	
ἐπεμβεβαώς	ἐπεμβαίνω	VB	number=SINGULAR|tense=PERF|mood=PARTICIPLE|voice=ACTIVE|gender=MASCULINE|case=NOMINATIVE	
πὰρ	παρά	PREP	_	
δ̓	δέ		_	
Ἀχλὺς	ἀχλύς	NN	number=SINGULAR|gender=FEMININE|case=NOMINATIVE	
εἱστήκει	ἵστημι	VB	person=PERSON_3|number=SINGULAR|tense=PLUSQUAMPERFECT|mood=INDICATIVE|voice=ACTIVE	
ἐπισμυγερή	ἐπισμυγερός	ADJ	number=SINGULAR|gender=FEMININE|case=NOMINATIVE	
τε	τε		_	
καὶ	καί	CONJ	_	
αἰνή	αἰνός	ADJ	number=SINGULAR|gender=FEMININE|case=NOMINATIVE	
χλωρὴ	χλωρός	ADJ	number=SINGULAR|gender=FEMININE|case=NOMINATIVE	
ἀυσταλέη	αὐσταλέος	ADJ	number=SINGULAR|gender=FEMININE|case=NOMINATIVE	
λιμῷ	λιμός	NN	number=SINGULAR|gender=MASCULINE|case=DATIVE	
καταπεπτηυῖα	καταπίπτω	VB	number=SINGULAR|tense=PERF|mood=PARTICIPLE|voice=ACTIVE|gender=FEMININE|case=NOMINATIVE	
γουνοπαχής	γουνοπαχής	ADJ	number=SINGULAR|gender=FEMININE|case=NOMINATIVE	
μακροὶ	μακρός	ADJ	number=PLURAL|gender=MASCULINE|case=NOMINATIVE	
δ̓	δέ		_	
ὄνυχες	ὄνυξ	NN	number=PLURAL|gender=MASCULINE|case=NOMINATIVE	
χείρεσσιν	χείρ	NN	number=PLURAL|gender=FEMININE|case=DATIVE	
ὑπῆσαν	ὕπειμι	VB	person=PERSON_3|number=PLURAL|tense=IMP|mood=INDICATIVE|voice=ACTIVE	
τὸν	ὁ	PRON	number=SINGULAR|gender=MASCULINE|case=ACCUSATIVE	
πρότερος	πρότερος	ADJ	number=SINGULAR|gender=MASCULINE|case=NOMINATIVE|degree=COMPARATIVE	
προσέειπε	προσεῖπον	VB	person=PERSON_3|number=SINGULAR|mood=INDICATIVE|voice=ACTIVE	
βίη	βία	NN	number=SINGULAR|gender=FEMININE|case=NOMINATIVE	
Ἡρακληείη	Ἡράκλειος	ADJ	number=SINGULAR|gender=FEMININE|case=NOMINATIVE	
τίς	τις	PRON	number=SINGULAR|gender=MASCULINE|case=NOMINATIVE	
κεν	ἄν		_	
ἐκείνου	ἐκεῖνος	ADJ	number=SINGULAR|gender=MASCULINE|case=GENITIVE	
ἔτλη	τλάω	VB	person=PERSON_3|number=SINGULAR|tense=IMP|mood=INDICATIVE|voice=ACTIVE	
θνητὸς	θνητός	ADJ	number=SINGULAR|gender=MASCULINE|case=NOMINATIVE	
ἐὼν	εἰμί	VB	number=SINGULAR|tense=PR|mood=PARTICIPLE|voice=ACTIVE|gender=MASCULINE|case=NOMINATIVE	
κατεναντίον	κατεναντίον	ADV	_	
ὁρμηθῆναι	ὁρμάω	VB	mood=INFINITIVE|voice=PASSIVE	
πλήν	πλήν	PREP	_	
γ̓	γε		_	
Ἡρακλῆος	Ἡρακλέης	NN	number=SINGULAR|gender=MASCULINE|case=GENITIVE	
καὶ	καί	CONJ	_	
κυδαλίμου	κυδάλιμος	ADJ	number=SINGULAR|gender=MASCULINE|case=GENITIVE	
Ἰολάου	Ἰόλαος	NN	number=SINGULAR|gender=MASCULINE|case=GENITIVE	
